Ha, Ha, Ha, Ha, Ha, Ha, Aa, Ha, Ha, Ha, Ha, Ha, Ha, Ha, Aa^Vea, Ha, Ha, Ha, Ha, Ha, Ha, Gg, Ms, Ias, Gd, Gd, Gd, Gd, Ias, Ias, Ias, Ias, Ias, Dd, Cte, Ias, Ias, Ias, Ias, Ias, Ias, Ias, Ias, Ias, Ias, Ias
Ha, Ha, Aa^Voa, Rra, Ha, Aa, Ha, Aa, Ha, Aa, Aa^Vea, Ha, Rra, Rra, Aa, Aa, Aa, Kva, Ha, Ha, Ms, Ms, Ha, Gd^Esa, Gd, Gd, Ias, Gd, Gd^Fetd, Gd, Gd, Gd, Gd^Fetd, Cud, Ias, Ias, Ias, Ias, Ias, Ias, Ias, Ias, Ias, Ias, Ias, Ias
Ha, Ha, Ha, Rra, Ha, Ha, Rra, Aa, Ha, Aa, Rra, Rra, Aa^Voa, Aa^Feta, Aa^Feta, Aa, Aa, Qxu^Bcx|, Aa^Fpa, Ha, Ha, Ms, Mdd^Xm, Gd, Ias, Cf, Cud, Cf, Gd^Fetd, Gd, Gd, Gd, Gd, Gd^Fetd, Ias, Ker, Ias, Ias, Ias, Ias, Ias, Ias, Ias, Ias, Ias, Ias
Ha, Aa^Feta, Aa, Ha, Aa, Aa, Ha, Ha, Rra, Aa, Aa, Rra, Rra, Aa^Feta, Aa, Aa, Aa^Fpa, Aa^Fpa, Aa^Vea, Aa^Fpa, Ha, Ms, Ha, Gd, Ias, Cf, Ias, Cf, Gll^Fmf, Gd^Fetd, Gd^Vhr, Gd, Gd, Gd^Fetd, Gd^Fetd, Ias, Ias, Ias, Ias, Ias, Ias, Ias, Gd^Vhr, Ias, Ias, Ias
Ha, Aa, Aa, Aa, Aa^Fpa, Aa^Fpa, Ha, Kh, Qxu^Bs\, Aa, Aa, Aa, Rra, Aa^Fma, Aa^Fma, Aa, Rra, Rra, Rra, Aa^Fpa, Ha, Ms, Ms, Gd^Esa, Ias, Ias, Ias, Ias, Gll^Fmf, Gd^Fetd, Gd, Gd, Cf, Ias, Gd^Fetd, Gd, Gd, Ias, Ias, Ias, Gd, Ias, Ias, Ias, Ias, Ias
Ha, Ha, Ha, Aa, Aa^Fpa, Aa^Fpa, Aa^Fpa, Ha, Aa^Fpa, Aa, Aa, Aa, Rra, Aa^Vea, Rra, Rra, Rra, Rra, Aa, Aa, Ha, Ms, Ha, Ms, Gd, Ias, Ias, Ias, Ias, Gd^Fetd, Ias, Cf, Cud, Cf, Ias, Gd^Fetd, Gd, Gd, Gd, Gd, Gd, Gll^Fmf, Gll^Fmf, Ias, Ias, Ias
Ha, Aa^Vea, Rra, Aa, Ha, Aa^Fpa, Aa^Fpa, Aa^Fpa, Aa, Aa, Aa, Aa, Aa, Rra, Rra, Rra, Aa, Aa, Aa^Fma, Aa^Fma, Ms, Ha, Ha, Gd^Esa, Ias, Ias, Ias, Ias, Ias, Ias, Ias, Cf, Cf, Cf, Ias, Gd^Fetd, Gll^Fmf, Gll^Fmf, Gll^Fmf, Gll^Fmf, Gll^Fmf, Gd^Fetd, Gll^Fmf, Gd, Gd, Ias
Ha, Rra, Qxu^Bh/, Kfr, Ha, Aa^Fpa, Aa, Aa, Aa, Aa, Aa, Aa, Aa, Aa, Aa, Aa, Aa^Fpa, Aa^Feta, Aa^Fpa, Aa^Feta, Ha, Ha, Ha, Ias, Ias, Gd^Vhr, Gd, Ias, Gll^Fdf, Gll^Fdf, Gll^Fdf, Ias, Ias, Ias, Ias, Ias, Gd^Fetd, Gll^Fmf, Ke, Gll^Fmf, Gll^Fmf, Gll^Fmf, Gd^Fetd, Gd, Gd, Gd
Ha, Ha, Aa^Feta, Ha, Ha, Aa, Aa, Aa, Aa, Aa^Feta, Aa, Aa, Aa, Aa, Aa, Aa, Aa^Fpa, Aa^Fpa, Aa^Feta, Aa^Feta, Ms, Ms, Gd^Esa, Ias, Gd^Vhr, Gll^Fmf, Gd, Ias, Gll^Fdf, Gll^Fdf, Gll^Fdf, Ias, Ias, Ias, Ias, Ias, Ias, Gll^Feth, Gll^Feth, Gll^Fmf, Gs^Ftp, Ke, Gd^Fetd, Gd^Fetd, Gd, Gd
Ha, Ha, Ha, Aa^Voa, Rra, Aa, Aa, Aa, Rra, Aa, Aa, Aa, Aa^Bsb/, Kfa, Aa, Aa, Aa^Fpa, Aa^Fpa, Aa^Feta, Ha, Ha, Ms, Ha, Ias, Ias, Gd, Gd, Gll^Fdf, Gll^Fdf, Gll^Fdf, Gll^Fdf, Ias, Ias, Hhd^Vhhr, Ias, Ias, Ias, Ias, Gll^Fmf, Gd^Fetd, Gll^Fdf, Gll^Fdf, Gll^Fdf, Gll^Fmf, Gd, Gd
Ha, Aa^Feta, Aa, Ha, Rra, Aa, Aa, Rra, Aa^Vea, Rra, Aa, Aa, Aa, Aa, Aa, Aa^Fpa, Aa^Fpa, Aa^Fpa, Aa^Feta, Aa^Feta, Ha, Ms, Gd, Ias, Cf, Cud, Cf, Gll^Fdf, Gll^Fdf, Gll^Fdf, Gll^Fmf, Ias, Gll^Fdf, Ias, Ias, Hhd^Vhhr, Ias, Ias, Gll^Fmf, Gll^Fmf, Gll^Fdf, Gll^Fdf, Gll^Fdf, Uue, Gd, Gd
Aa, Ha, Rra, Aa, Aa, Aa, Aa, Rra, Rra, Rra, Aa, Aa, Aa, Aa, Aa, Aa, Aa^Feta, Aa^Feta, Aa, Aa, Ms, Ha, Ms, Gd, Ias, Gd, Gd, Gd, Gll^Fmf, Gll^Fdf, Gll^Fdf, Gll^Fdf, Gll^Fdf, Ias, Ias, Ias, Ias, Ias, Ias, Gll^Fmf, Gll^Fdf, Gll^Fdf, Gll^Fdf, Gll^Fdf, Gd, Gd
Aa, Aa, Aa, Aa, Aa^Feta, Aa, Aa, Aa, Aa, Aa, Rra, Aa, Aa, Aa, Aa, Aa, Aa, Aa, Aa, Aa, Ms, Kme, Mdd^Xm, Mdd^Xm, Gd, Gd^Vhr, Gll^Fdf, Gll^Fdf, Gll^Fdf, Gll^Fdf, Gd^Fetd, Gll^Feth, Gll^Feth, Gd^Fetd, Gd^Fetd, Ias, Ias, Ias, Gll^Fdf, Gll^Fmf, Gll^Fdf, Ias^Edp, Ke, Dd, Wwf, Gd
Aa, Rra, Aa, Kh, Aa, Aa, Aa, Aa, Aa, Aa, Rra, Rra, Rra, Aa, Aa, Aa, Aa, Aa, Aa, Aa, Aa, Mm, Sm, Gd, Rb, Gd, Gll^Fdf, Gll^Fdf, Gll^Fdf, Gll^Feth, Gll^Feth, Ke, Gd^Fetd, Gd^Fetd, Gd, Gll^Fdf, Ias, Ias, Gd, Gd, Sm, Ias, Sm, Dd, Wwf, Xu
Aa, Aa, Aa, Qxu^Bs|, Aa, Aa^Fpa, Aa^Fpa, Aa^Fpa, Aa, Aa, Rra, Kva, Aa, Aa, Aa, Aa^Feta, Aa, Aa, Aa, Aa, Aa, Mdd^Xm, Sm, Sm, Rb, Sm, Rb, Sm, Sm, Gll^Feth, Gd^Fetd, Gd^Fetd, Sm, Sm, Sm, Gd, Sm, Sm, Sm, Sm, Sm, Sm, Sm, Sm, Wwrt, Xu
Aa, Aa^Feta, Aa, Aa, Aa, Aa^Fpa, Aa^Fpa, Aa^Fpa, Aa^Fpa, Aa, Aa, Rra, Rra, Aa, Aa, Aa, Aa, Aa, Aa, Aa, Ha, Mm, Wwf, Rr^Vhc, Rb, Rb, Rb, Sm, Sm, Sm, Sm, Sm, Sm, Sm, Rb, Sm, Wwt, Sm, Sm, Sm, Wwf, Sm, Wwt, Wwr, Xu, Xu
Gg, Aa, Gg, Aa, Gg, Aa^Fpa, Gg, Aa^Fpa, Gg, Aa, Gg, Aa, Gg, Aa, Gg, Aa, Aa, Aa, Gg^Esa, Gg^Esa, Hh, Mm, Wwf, Gs, Ww, Wwf, Wwg, Wwf, Wwf, Sm, Wwf, Wwf, Wwf, Rb, Rb^Efm, Wwt, Rr^Vhc, Rb^Efm, Wwt, Wwf, Wwf, Wwf, Wwr, Wwr, Wwr, Xu
Gg, Gg, Gg, Gg, Gg, Gg, Gg, Gg, Gg, Gg, Gg, Gg, Gg, Gg, Gg, Gg, Gg, Aa^Voa, Gg^Esa, Gg^Esa, Hh, Mm, Wwf, Wwt^Bsb|, Ww, Ww, Wwg, Ww, Ww, Ww, Ww, Wwt, Wwt, Rb, Wwt, Rb^Efm, Rb, Rb, Wwt, Wwt, Wwt, Wwr, Wwrg, Wwr, Xu, Xu
Gg, Gg, Gg^Esa, Gg, Gg, Gg^Esa, Gg^Esa, Gg, Gg^Esa, Ss, Gg^Esa, Gll, Gll^Bw/r, Gg, Gll, Gg, Gg, Gg^Esa, Gg, Gg, Irs, Mm, Wwf, Wwt^Bsb|, Ww, Ww, Wwg, Ww, Ww, Ww, Ww, Wwg, Wwg, Wwt, Rb, Rb, Wwt, Wwt, Wwt, Wwt, Wwt, Wwt, Wwrg, Wwrg, Xu, Xu
Gg, Gll, Gg, Gg^Esa, Gg, Gg, Gll, Gg^Esa, Ss, Ss, Ww^Bw/r, Ss^Bw/r, Gg, Gll, Gll, Gg, Gg, Gg, Gg, Gll, Irs, Mm, Wwt, Ww^Bsb|, Ww, Ww, Ww, Wwg, Ww, Ww, Wwg, Wwg, Ww, Wwg, Wwt, Wwt^Bsb\, Wwt^Bsb\, Wwt, Wwt, Wwt, Wwt, Wwt, Wot, Wwrg, Wwrt, Xu
Gg, Gg^Gvs, Gg, Chs, Rrc, Gg, Gg, Gg, Gg^Bw/r, Ww^Bw/r, Gg^Esd, Ss, Gs^Fds, Gs^Fds, Gs^Fds, Gs^Fds, Gg, Gll, Gg, Gll, Hhd, Mm, Wwt, Gs, Gs, Wwg, Ww, Wwg, Ww, Wwg, Ww, Ww, Ww, Ww, Wwt, Wwt, Wwt, Wwt^Bsb\, Wwt^Bsb\, Wwt, Wwt, Wwt, Wwt, Wwrg, Xu, Xu
Gg, Gg^Gvs, Gg, Rrc, Gg^Gvs, Rrc, Rrc, Rrc, Ss, Ww^Ewl, Ww^Ewl, Gg, Gg, Gg, Gg, Gs^Fds, Gll, Gll, Irs, Irs, Mm, Mm, Wwt, Rr^Vhc, Wwt, Wwt, Wwt, Wwg, Wwg, Ww, Ww, Ww, Ww, Wwt, Ww, Ww, Wwt, Wwt, Wwt, Wwt^Bsb\, Wwt^Bsb\, Cme, Cme, Wwt, Wwr, Xu
Gg, Gg^Gvs, Gg, Rrc, Gg^Gvs, Gg^Gvs, Gg^Gvs, Rrc, Rrc, Ss, Gg^Esd, Gg^Esd, Gg, Gs^Vh, Gg^Edp, Gg, Gll, Gg, Irs, Irs, Mm, Mm, Wwt, Mm, Mm, Wwt, Rb, Wwt, Ww, Ww, Ww, Ww, Ww, Ww, Wwg, Wwg, Kh, Wwt, Wwt, Wwt, Rb, Km, Rb, Wwt, Ww, Wwrt
Gg, Gg^Dr, Gg^Gvs, Rrc, Gg^Gvs, Gg^Dr, Gg^Gvs, Gg^Gvs, Gg, Rrc^Esd, Rrc, Gg^Esd, Gg, Gll, Gg, Gg, Irs, Irs, Cv, Mm, Hhd, Mm, Wwt, Mm, Wwt, Uue, Rr^Vhc, Wwg, Ww, Wwg, Wwg, Ww, Wwg, Wwg, Sm^Bsb/, Sm^Bsb/, Rb^Gvs, Sm^Bsb\, Sm^Bsb\, Rb, Wwt, Wwt, Sm^Bsb/, Rb, Wwrt, Wwrt
Gg, Gg^Gvs, Gg, Rrc, Gg^Gvs, Gs^Fds, Gg^Gvs, Gg^Fet, Gg, Gg^Gvs, Gg^Gvs, Rrc, Rrc, Gg, Irs, Irs, Rrc, Rrc, Hhd, Hhd, Hhd, Mm, Wwt, Uhe, Mm, Mm, Mm, Gs, Ww, Wwg, Wwg, Wwg, Sm^Bsb/, Sm^Bsb/, Rb^Gvs, Rb^Gvs, Gs, Rb^Gvs, Rb^Gvs, Rb, Sm^Bsb/, Sm^Bsb/, Wwt, Wwt, Wwrg, Wwrt
Gg, Gg^Fet, Gg^Gvs, Rrc^Esd, Gg^Gvs, Gs^Fds, Gg^Gvs, Gg^Gvs, Rp, Gs^Vht, Rp^Gvs, Gg^Fet, Rp, Rrc, Rrc, Rrc, Gg^Gvs, Irs, Hhd, Hhd, Hhd, Md, Wwt, Wwt, Wwt, Wwt, Wwt, Wwt^Bsb|, Ww, Wwg, Wot, Rb, Rb^Gvs, Rr^Vhc, Rb^Gvs, Rb^Gvs, Gs, Gs, Sm^Bsb/, Sm^Bsb/, Ww, Wwt, Ww, Ww, Wwrt, Wwrt
Gg, Gg^Gvs, Gg^Gvs, Rrc, Rp, Rp^Gvs, Rp, Rp^Esd, Gg^Gvs, Rp, Gg^Gvs, Rp, Rp, Rrc, Gs^Vht, Gg^Gvs, Gg, Gg, Hhd, Hhd, Hhd, Mm, Md, Wwt, Wwt, Ww, Ww, Ww^Bsb|, Wog, Wot, Rb, Gs, Rb^Gvs, Rb^Gvs, Rb^Gvs, Gs, Sm^Bsb/, Sm^Bsb/, Ww, Ww, Ww, Ww, Ww, Ww, Wwrt, Wwrt
Gg, Gg^Gvs, Rp, Gs^Vht, Rp, Rp, Gll, Gg^Gvs, Gg^Gvs, Gg, Rp, Rp, Rp, Rp, Irs, Rp, Rp, Gg^Ve, Hh, Hhd, Hh, Mm, Wwt, Wwt, Wwt, Wwt, Wwt, Wog^Bsb|, Rb, Rb, Rb^Gvs, Rb^Gvs, Ch, Ch, Cme, Sm^Bsb/, Ww, Ww, Ww, Ww, Wot, Ww, Ww, Ww, Wwrt, Wwrt
Gg^Gvs, Gg, Gg^Gvs, Rp, Rp, Gll, Gll, Gs^Vh, Rp, Rp, Rp, Kvr, Gll, Irs, Irs, Irs, Irs, Irs, Hhd, Hh, Md, Mm, Md, Wwt, Cme, Cme, Ch, Wog^Bsb|, Rb, Wog, Rb, Rb^Gvs, Cme, Km, Cme, Ww, Ww, Ww, Ww^Ii, Ww, Wot, Ww, Ww, Ww, Wwrt, Wwrt
Gg, Gg^Gvs, Rp, Rp, Rp, Kv, Gll, Gg^Gvs, Gg^Fet, Gg^Gvs, Gg^Gvs, Rp, Irs, Irs, Irs, Irs, Irs, Irs, Hhd, Hhd, Hh, Mm, Wwt, Gs, Gs, Kh, Rb, Rb, Wog, Wog^Bsb\, Rb, Sm^Bsb/, Ww, Cme, Ww, Ww^Bsb\, Ww^Bsb\, Ww^Ii, Ww, Ww, Ww, Ww, Ww, Ww, Wot, Wwrt
Gg, Gg^Vwm, Rp, Rp, Gg^Gvs, Gg^Gvs, Gg^Gvs, Gg^Gvs, Gg^Edb, Gg^Gvs, Gg^Gvs, Irs, Irs, Irs, Irs, Irs, Irs, Irs, Hhd, Hhd, Mm, Mm, Wwt, Wwt, Gs, Gs, Ww, Wog, Wog^Ii, Wog, Wog, Ww, Wot, Wot^Ii, Wot, Ww^Ii, Ww, Ww^Bsb\, Rb, Rb, Uhe, Ww, Ww, Wot, Wwrt, Wwrt
Gg, Gg^Gvs, Gg^Gvs, Gg, Gg^Gvs, Gg^Fet, Gs^Fds, Gg^Fet, Gs^Fds, Gg^Fet, Gs^Fds, Gg^Gvs, Irs, Irs, Irs, Cv, Irs, Irs, Irs, Hhd, Md, Mm, Mm, Rr^Vhc, Wwt, Ww, Ww, Ww, Ww, Wog^Ii, Wog, Ww^Ii, Wot, Wot^Ii, Ww, Ww^Ii, Ww, Ww, Rb^Gvs, Rr^Vhc, Ww, Ww, Ww, Wot, Wwrg, Wwrt
Gg^Gvs, Gg^Gvs, Gg^Gvs, Gg^Gvs, Gg^Fet, Gg^Fet, Gg^Fet, Gg^Fet, Gg^Fet, Gs^Fds, Gg^Gvs, Gg^Gvs, Gg, Irs, Irs, Irs, Irs, Irs, Gd^Vo, Hhd, Hh, Mm, Wwt, Wwt, Ww, Ww, Wwt, Ww, Ww, Wog, Ww, Ww, Ww, Ww, Ww^Ii, Ww, Ww, Ww, Ww, Rb^Gvs, Ww, Wot, Ww, Wwrg, Wwrt, Wwrt
Gg^Gvs, Gg^Gvs, Gg^Gvs, Gg^Fet, Gg^Gvs, Gs^Fds, Gg^Fet, Gg^Fet, Gg^Gvs, Gg^Gvs, Gg^Gvs, Gg^Vwm, Rp, Irs, Irs, Irs, Irs, Irs, Hhd, Hhd, Md, Mm, Wwt, Wwt, Ww, Ww, Ww, Ww, Ww, Ww, Ww, Ww, Ww, Ww, Ww, Ww, Wwr, Ww, Ww, Wwr, Ww, Wot, Ww, Wwrt, Wwrt, Wwrt
Gg, Gg^Gvs, Gg^Gvs, Gg^Gvs, Gg^Gvs, Gg^Gvs, Gg, Gg^Gvs, Gg^Gvs, Gg^Gvs, Gg, Gg, Gg, Gg, Gg, Rp, Gg, Gg, Gg, Hhd, Gg, Mm, Gg, Wwr, Gg, Ww, Gg, Ww, Gg, Ww, Sm, Ww, Ww, Ww, Ww, Ww, Ww, Ww, Ww, Ww, Ww, Ww, Gg, Wwrt, Sm, Wwrt
