Mm, Ha, Mm, Mm, Mm, Mm, Gg, Gg, Mm, Mm, Mm, Ha, Mm, Mm, Gg, Mm, Mm, Mm, Mm, Hhd, Hhd, Gg, Ms^Xm, Dd, Dd, Dd, Dd, Dd, Dd, Dd, Dd, Dd, Dd, Dd, Dd, Dd, Dd, Dd, Dd, Dd, Dd, Dd, Dd, Dd, Dd, Dd
Mm, Mm, Gd^Vo, Rp, Mm, Gg, Mm, Gg, Mm, Gg, Gg^Ve, Mm, Rp, Rp, Gg, Gg, Gg, Mm, Hhd, Hhd, Mm, Mm, Ms^Xm, Ms^Xm, Dd, Dd, Dd, Dd, Dd, Dd, Dd, Dd, Dd, Cd, Dd, Dd, Dd, Dd, Dd, Dd, Dd, Dd, Dd, Dd, Dd, Dd
Mm, Mm, Mm, Rp, Mm, Mm, Rp, Gg, Mm, Gg, Rp, Rp, Gg^Ve, Gll^Fmw, Gll^Fmw, Gg, Gg, Kva, Gll^Fmw, Hhd, Hh, Mm, Ms^Xm, Ms^Xm, Dd, Dd, Cd, Dd, Dd, Dd, Dd, Dd, Dd, Dd, Dd, Ker, Dd, Dd, Dd, Dd, Dd, Dd, Dd, Dd, Dd, Dd
Mm, Gg^Fet, Sm, Sm, Sm, Sm, Mm, Mm, Rp, Gg, Gg, Rp, Rp, Gll^Fmw, Gg, Gg, Gll^Fmw, Qxu^Bcx|, Gg^Ve, Gll^Fmw, Hh, Mm, Ms^Xm, Ms^Xm, Dd, Dd, Dd, Dd, Dd, Dd, Ke, Dd, Dd, Dd, Dd, Dd, Dd, Dd, Dd, Dd, Dd, Dd, Ker, Dd, Dd, Dd
Mm, Sm, Sm, Sm, Gll^Fmw, Gll^Fmw, Mm, Kh, Qxu^Bs\, Gg, Gg, Gg, Rp, Gll^Fmw, Gll^Fmw, Gg^Efm, Rp, Rp, Rp, Gll^Fmw, Hh, Mm, Ms^Xm, Ms^Xm, Dd, Dd, Dd, Dd, Dd, Dd, Dd, Dd, Dd, Dd, Dd, Dd, Dd, Dd, Dd, Dd, Dd, Dd, Dd, Dd, Dd, Dd
Mm, Mm, Mm, Sm, Gll^Fmw, Gll^Fmw, Gll^Fmw, Mm, Gll^Fmw, Gg, Gg, Gg, Rp, Gg^Ve, Rp, Rp, Rp, Rp, Gg, Gg, Hh, Mm, Ms^Xm, Ms^Xm, Dd, Dd, Dd, Dd, Dd, Dd, Dd, Dd, Cd, Dd, Dd, Dd, Dd, Dd, Dd, Dd, Dd, Dd^Es, Dd^Es, Dd, Dd, Dd
Mm, Aa^Vea, Rp, Sm, Mm, Gll^Fmw, Gll^Fmw, Gll^Fmw, Gg, Gg, Gg, Gg, Gg, Rp, Rp, Rp, Gg^Efm, Gg, Gll^Fmw, Gll^Fmw, Mm, Hh, Ms^Xm, Ms^Xm, Dd, Dd, Dd, Dd, Dd^Esd, Dd, Dd^Esd, Dd, Dd, Dd, Dd, Dd, Dd, Dd, Dd, Dd, Dd, Dd^Es, Dd^Es, Dd, Dd, Dd
Mm, Rp, Rp, Kfr, Mm, Gll^Fmw, Gg, Gg, Gg, Gg, Gg, Gg, Gg, Gg, Gg^Efm, Gg^Efm, Ww^Ewl, Gg^Fet, Gll^Fmw, Gg^Fet, Hh, Hh, Ms^Xm, Ms^Xm, Dd, Ke, Dd, Dd, Dd, Dd^Esd, Dd^Es, Dd, Dd, Dd, Dd, Dd, Gd^Fetd, Dd, Ke, Dd, Gd^Fetd, Dd, Gd^Fetd, Dd, Dd, Dd
Mm, Mm, Gg^Fet, Mm, Mm, Gg, Gg, Gg, Gg, Gg^Fet, Gg, Gg, Gg, Gg, Gg^Efm, Gg^Efm, Ww^Ewl, Ww^Ewl, Gg^Fet, Gg^Fet, Mm, Mm, Ms^Xm, Ms^Xm, Ke, Dd, Dd, Dd, Dd, Tb, Dd^Es, Dd, Dd, Dd, Dd, Dd, Dd, Gll^Feth, Tb, Dd, Gd^Fetd, Ke, Tb, Tb, Dd, Dd
Mm, Mm, Mm, Aa^Voa, Rp, Gg, Gg, Gg, Rp, Gg, Gg, Gg, Aa^Bsb/, Cfr, Gg^Efm, Gg, Ww^Ewl, Ww^Ewl, Gg^Fet, Hh, Hh, Mm, Ms^Xm, Ms^Xm, Dd, Dd, Dd, Dd, Dd, Dd, Dd, Dd, Dd, Ke, Dd, Dd, Dd, Dd, Gd^Fetd, Gd^Fetd, Rd, Rd, Rd, Tb, Dd, Dd
Mm, Gg^Fet, Gg, Mm, Rp, Gg, Gg, Rp, Gg^Ve, Rp, Gg, Gg, Gg, Gg, Gg^Efm, Ww^Ewl, Ww^Ewl, Ww^Ewl, Gg^Fet, Gg^Fet, Hh, Mm, Ms^Xm, Ms^Xm, Dd, Cd, Dd, Dd, Dd, Dd, Dd, Dd, Dd, Dd, Dd, Ke, Dd, Dd, Gd^Fetd, Gd^Fetd, Rd, Rd, Rd, Gd^Fetd, Dd, Dd
Rp, Mm, Rp, Gg, Gg, Gg, Gg, Rp, Rp, Rp, Gg, Gg, Gg, Gg, Gg, Gg^Efm, Gg^Fet, Gg^Fet, Gg, Gg, Mm, Hh, Ms^Xm, Dd, Dd, Dd, Dd, Dd, Dd, Dd, Dd, Dd, Dd^Dr, Dd, Dd, Dd^Ebn, Dd, Dd, Gd^Fetd, Tb, Tb, Rd, Gd^Fetd, Gd^Fetd, Dd, Dd
Rp, Rp, Rp, Gg, Gg^Fet, Gg, Gg, Gg, Gg, Gg, Gg, Gg, Gg, Gg, Gg, Gg, Gg, Gg, Gg, Gg, Mm, Kme, Ms^Xm, Mdd^Xm, Dd, Ke, Dd, Tb, Dd, Dd, Dd^Dr, Tb, Tb, Dd, Dd, Dd, Dd, Dd, Gd^Fetd, Tb, Gd^Fetd, Tb, Ke, Dd, Dd, Dd
Gg, Rp, Gg, Kh, Gg, Gg, Gg, Gg, Gg, Gg, Rp, Rp, Rp, Gg, Gg, Gg, Gg, Gg, Gg, Gg, Gg, Mm, Ms^Xm, Dd, Dd, Dd, Dd, Dd, Dd^Es, Dd^Dr, Tb, Ke, Tb^Es, Dd^Dr, Dd, Gll^Fdf, Dd, Dd, Dd, Dd, Dd, Dd, Dd, Dd, Dd, Dd
Gg, Gg, Gg, Qxu^Bs|, Gg, Gs^Fms, Gs^Fms, Gs^Fms, Gg, Gg, Rp, Kv, Rp, Gg, Gg, Gg^Fet, Gg, Gg, Mm, Gg, Gg, Mdd^Xm, Ms^Xm, Dd, Dd, Dd, Dd, Dd, Dd, Dd^Es, Dd^Es, Tb, Dd^Es, Dd^Es, Dd, Dd, Dd, Dd, Dd, Dd, Dd, Dd, Dd, Dd, Dd, Dd
Gg, Gg^Fet, Gg, Gg, Gg, Gs^Fms, Gs^Fms, Gs^Fms, Gs^Fms, Gg, Gg, Rp, Gg, Gg, Gg, Gg, Gg, Gg, Gg, Gg, Gg, Gg, Ms^Xm, Dd, Dd, Dd, Dd, Dd, Dd, Dd, Tb, Tb, Dd, Dd^Es, Dd, Dd, Dd, Dd, Dd, Dd, Dd, Dd, Dd, Dd, Dd, Dd
Gg, Gg, Gg, Gg, Gg, Gs^Fms, Gg, Gs^Fms, Gg, Gg, Gg, Gg, Gg, Gg, Gg, Gg, Gg, Gg, Gg, Gg, Gg, Mm, Ms^Xm, Dd, Dd, Dd, Dd, Dd, Dd, Dd, Dd, Tb, Dd, Dd, Dd, Dd, Rr^Vhc, Dd, Dd, Dd, Dd, Dd, Dd, Dd, Dd, Dd
Gd, Gg, Gd, Gg, Gd, Gg, Gd^Es, Gg, Gd^Es, Gg, Gd, Gg, Gd, Gg, Gd, Gg, Gd, Gg, Gd, Gg, Gd, Gg, Ms^Xm, Dd, Wot, Dd, Wot, Dd, Wot, Dd, Wot, Dd, Qxu^Bcx\, Dd, Wot, Dd, Wot, Dd, Wot, Dd, Wot, Dd, Wot, Dd, Wot, Dd
Gd, Gd, Gd, Gd, Gd, Gd, Gd^Es, Gd^Es, Gd^Es, Ss, Gg^Esa, Gll, Gll^Bw/r, Gd, Gll, Gd, Gd, Gd, Gd, Gd, Gd, Gd, Ms^Xm, Ms^Xm, Wot, Wot, Wot, Wot, Wot, Wot, Wot, Wot, Wot, Qxu^Bcx\, Qxu^Bcx\, Wot, Wot, Wot, Wot, Wot, Wot, Wot, Wot, Wot, Wot, Wot
Gs^Fms, Gll, Gd, Gd, Gd, Gd^Es, Gll^Es, Gd^Es, Ss, Ss, Ww^Bw/r, Ss^Bw/r, Gg, Gll, Gll, Gd, Gd, Gd, Gd, Gd, Gd, Gd, Ms^Xm, Wot, Wot, Wot, Wot, Wot, Wot, Wot, Sm, Wot, Wot, Wot, Wot, Qxu^Bcx\, Qxu^Bcx\, Wot, Wot, Wot, Wot, Wot, Wot, Wot, Wot, Wot
Gg, Gd^Gvs, Gd^Gvs, Chs, Rrc, Gd, Gd, Gd, Gg^Bw/r, Ww^Bw/r, Gg^Esd, Ss, Gs^Fds, Gs^Fds, Gs^Fds, Gs^Fds, Gd, Gll, Gd, Gd, Gd, Mm, Ms^Xm, Ms^Xm, Wot, Wot, Wot, Wot, Sm, Sm, Sm, Sm, Sm, Wot, Wot, Wot, Wot, Qxu^Bcx\, Qxu^Bcx\, Wot, Wot, Wot, Wot, Wot, Wot, Wot
Gg, Gd^Gvs, Gd^Gvs, Rrc, Gd^Gvs, Rrc, Rrc, Rrc, Ss, Ww^Ewl, Ww^Ewl, Gg, Gd, Gg, Gd, Gs^Fds, Gll, Gll, Gll, Gd, Gd, Mm, Ms^Xm, Ms^Xm, Wot, Wot, Wot, Wot, Sm, Sm, Sm, Sm, Sm, Wot, Wot, Wot, Wot, Wot, Wot, Qxu^Bcx\, Qxu^Bcx\, Wot, Wot, Wot, Wot, Wot
Gg, Gd^Gvs, Gd^Gvs, Rrc, Gd^Gvs, Gd^Gvs, Gd^Gvs, Rrc, Rrc, Ss, Gg^Esd, Gg^Esd, Gd, Gs^Vh, Gd, Gd, Gll, Gd, Gd, Gd, Gd, Mm, Ms^Xm, Ms^Xm, Mm, Wot, Wot, Wot, Wot, Sm, Sm, Sm, Wot, Wot, Wot, Wot, Kud, Wot, Wot, Wot, Wot, Qxu^Bcx\, Qxu^Bcx\, Wot, Kud, Uhe
Gg, Gg^Dr, Gd^Gvs, Rrc, Gd^Gvs, Gg^Dr, Gd^Gvs, Gd^Gvs, Gd, Rrc^Esd, Rrc, Gg^Esd, Gd, Gll, Gd, Gd, Gd, Gd, Cv, Gd, Gd, Mm, Ms^Xm, Ms^Xm, Uue, Uue, Rr^Vhc, Wot, Wot, Wot, Wot, Wot, Wot, Wot, Sm^Bsb/, Sm^Bsb/, Wot, Sm^Bsb\, Sm^Bsb\, Wot, Wot, Wot, Sm^Bsb/, Sm^Bsb/, Uue, Uhe
Gg, Gd^Gvs, Gd, Rrc, Gd^Gvs, Gs^Fds, Gd^Gvs, Gg^Fet, Gd, Gd^Gvs, Gd^Gvs, Rrc, Rrc, Gd, Gd^Gvs, Gd, Rrc, Rrc, Gd, Gd, Gd, Mm, Ms^Xm, Ms^Xm, Mm, Mm, Mm, Wot, Wot, Wot, Wot, Wot, Sm^Bsb/, Sm^Bsb/, Wot, Wot, Sm, Wot, Wot, Sm^Bsb\, Sm^Bsb/, Sm^Bsb/, Sm^Bsb/, Sm^Bsb/, Wot, Uhe
Gd^Gvs, Gg^Fet, Gd^Gvs, Rrc^Esd, Gd^Gvs, Gs^Fds, Gd^Gvs, Gd^Gvs, Rp, Gs^Vht, Rp^Gvs, Gg^Fet, Rp, Rrc, Rrc, Rrc, Gd^Gvs, Gd, Gd, Gd, Gd, Md, Ms^Xm, Qxe, Wot, Uue, Uhe, Wot, Wot, Wot, Sm^Bsb/, Wot^Bsb/, Wot, Rr^Vhc, Wot, Sm, Wot, Wot, Sm^Bsb/, Sm^Bsb/, Wot, Sm^Bsb/, Wot, Wot, Uhe, Wot
Gg, Gd, Gd^Gvs, Rrc, Rp, Rp^Gvs, Rp, Rp^Esd, Gd^Gvs, Rp, Gd^Gvs, Rp, Rp, Rrc, Gs^Vht, Gd^Gvs, Gd, Gd, Gd, Gd, Gd, Ms^Xm, Ms^Xm, Wot, Uue, Wot, Uhe, Wot, Km, Sm^Bsb/, Wot, Wot, Wot, Wot, Wot, Wot, Sm^Bsb/, Sm^Bsb/, Wot, Wot, Wot, Wot, Wot, Wot, Uhe, Sm
Gg, Gd^Gvs, Rp, Gs^Vht, Rp, Rp, Gll, Gd^Gvs, Gd^Gvs, Gd^Gvs, Rp, Rp, Rp, Rp, Gd^Gvs, Rp, Gd, Gg^Ve, Gd, Gd, Gd, Gd, Ms^Xm, Uue, Wot, Wot, Uue, Wot, Wot, Wot, Wot, Wot, Wot, Wot, Sm^Bsb/, Sm^Bsb/, Wot, Wot, Wot, Uhe, Uhe, Wot, Uhe, Uhe, Wot, Wot
Gg^Gvs, Gd, Gd^Gvs, Rp, Rp, Gll, Gll, Gs^Vh, Rp, Rp, Rp, Kvr, Gll, Gd^Gvs, Gd, Gll, Rp, Gd, Gd, Gd, Gd, Gd, Ms^Xm, Uue, Wot, Wot, Uue, Wot, Rr^Vhc, Wot, Wot, Sm^Bsb/, Sm^Bsb/, Kud, Wot, Wot, Wot, Wot, Wot, Uhe, Uhe, Uhe, Uhe, Uhe, Wot, Wot
Gd, Gd^Gvs, Rp, Rp, Rp, Kv, Gll, Gd^Gvs, Gg^Fet, Gd^Gvs, Gd^Gvs, Rp, Gll, Gd, Gll, Gd, Rrc, Gd, Gd, Gd, Gd, Gd, Ms^Xm, Uue, Wot, Kud, Wot, Wot, Wot, Wot, Wot, Sm^Bsb/, Wot, Wot, Sm, Wot, Wot, Wot, Wot, Uhe, Uhe, Uhe, Uhe, Uhe, Wot, Wot
Gd, Gd^Wm, Rp, Rp, Gd^Gvs, Gg^Gvs, Gd^Gvs, Gg^Gvs, Gg^Edb, Gg^Gvs, Gd^Gvs, Rp, Rp, Rrc, Rrc, Gd, Rrc, Gd, Gd, Gd, Gd, Gd, Ms^Xm, Uue, Wot, Wot, Sm, Sm, Sm, Sm, Sm, Sm, Sm, Sm, Wot, Wot, Wot, Wot, Uhe, Uhe, Uhe, Wot, Uhe, Wot, Wot, Wot
Gg, Gd^Gvs, Gd^Gvs, Gd, Gg^Gvs, Gg^Fet, Gs^Fds, Gg^Fet, Gs^Fds, Gg^Fet, Gs^Fds, Gd^Gvs, Gd^Gvs, Gd, Gd, Cv, Gd, Gd, Gd, Gd, Gd, Ms^Xm, Ms^Xm, Uue, Wot, Wot, Wot, Sm, Wot, Sm, Wot, Sm, Wot, Wot, Wot, Uhe, Uhe, Uhe, Wot, Rr^Vhc, Uhe, Wot, Wot, Uhe, Wot, Wot
Gg^Gvs, Gd^Gvs, Gg^Gvs, Gg^Gvs, Gg^Fet, Gg^Fet, Gg^Fet, Gg^Fet, Gg^Fet, Gs^Fds, Gd^Gvs, Gd^Gvs, Gd, Gd, Urc, Rrc, Rp, Gd, Gd^Vo, Gd, Gd, Mm, Ms^Xm, Uue, Uue, Wot, Wot, Wot, Wot, Wot, Uhe, Wot, Uhe, Uhe, Uhe, Uhe, Uhe, Wot, Wot, Wot, Uhe, Uhe, Wot, Wot, Wot, Wot
Gg^Gvs, Gd^Gvs, Gd^Gvs, Gg^Fet, Gd^Gvs, Gs^Fds, Gg^Fet, Gg^Fet, Gd^Gvs, Gg^Gvs, Gd^Gvs, Gd^Wm, Rp, Rp, Rp, Gd, Rp, Rp, Hhd, Gd, Gd, Ms^Xm, Ms^Xm, Uue, Uue, Uue, Sm, Uhe, Sm, Uhe, Sm, Uhe, Uhe, Uhe, Uhe, Uhe, Wot, Wot, Wot, Uhe, Wot, Wot, Wot, Wot, Wot, Wot
Gg, Gd^Gvs, Gg^Gvs, Gd^Gvs, Gg^Gvs, Gd^Gvs, Gg, Gg^Gvs, Gg^Gvs, Gd^Gvs, Gg, Gd, Gg, Gd, Gd, Rp, Gd, Gd, Gg, Hhd, Gg, Ms^Xm, Ms^Xm, Wot, Wot, Sm, Wot, Sm, Wot, Sm, Wot, Sm, Wot, Uhe, Wot, Wot, Wot, Wot, Wot, Wot, Wot, Wot, Wot, Wot, Wot, Wot
