Mm, Ha, Mm, Mm, Mm, Mm, Gg, Gg, Mm, Mm, Mm, Ha, Mm, Mm, Aa^Vea, Mm, Mm, Mm, Mm, Hhd, Hhd, Gg, Mm, Dd, Dd, Dd, Dd, Dd, Dd, Dd, Dd, Dd, Dd, Dd, Dd, Dd, Dd, Dd, Dd, Dd, Dd, Dd, Dd, Dd, Dd, Dd
Mm, Mm, Aa^Voa, Rp, Mm, Gg, Mm, Gg, Mm, Gg, Aa^Vea, Mm, Rp, Rp, Gg, Gg, Gg, Kva, Hhd, Hhd, Mm, Mm, Hh, Dd, Dd, Dd, Dd, Dd, Dd, Dd, Dd, Dd, Dd, Cd, Dd, Dd, Dd, Dd, Dd, Dd, Dd, Dd, Dd, Dd, Dd, Dd
Mm, Mm, Mm, Rp, Mm, Mm, Rp, Gg, Mm, Gg, Rp, Rp, Aa^Voa, Gll^Fmw, Gll^Fmw, Gg, Gg, Qxu^Bcx|, Gll^Fmw, Hhd, Hh, Mm, Mdd^Xm, Dd, Dd, Dd, Cd, Dd, Dd, Dd, Dd, Dd, Dd, Dd, Dd, Ker, Dd, Dd, Dd, Dd, Dd, Dd, Dd, Dd, Dd, Dd
Mm, Gg^Fet, Sm, Sm, Sm, Sm, Mm, Mm, Rp, Gg, Gg, Rp, Rp, Gll^Fmw, Gg, Gg, Gll^Fmw, Gll^Fmw, Aa^Vea, Gll^Fmw, Hh, Mm, Hh, Dd, Dd, Dd, Dd, Dd, Dd, Dd, Ke, Dd, Dd, Dd, Dd, Dd, Dd, Dd, Dd, Dd, Dd, Dd, Ker, Dd, Dd, Dd
Mm, Sm, Sm, Sm, Gll^Fmw, Gll^Fmw, Mm, Kh, Qxu^Bs\, Gg, Gg, Gg, Rp, Gll^Fmw, Gll^Fmw, Gg^Efm, Rp, Rp, Rp, Gll^Fmw, Hh, Mm, Mm, Dd, Dd, Dd, Dd, Dd, Dd, Dd, Dd, Dd, Dd, Dd, Dd, Dd, Dd, Dd, Dd, Dd, Dd, Dd, Dd, Dd, Dd, Dd
Mm, Mm, Mm, Sm, Gll^Fmw, Gll^Fmw, Gll^Fmw, Mm, Gll^Fmw, Gg, Gg, Gg, Rp, Aa^Vea, Rp, Rp, Rp, Rp, Gg, Gg, Hh, Mm, Hh, Mm, Dd, Dd, Dd, Dd, Dd, Dd, Dd, Dd, Cd, Dd, Dd, Dd, Dd, Dd, Dd, Dd, Dd, Dd^Ftd, Dd^Do, Dd, Dd, Dd
Mm, Aa^Vea, Rp, Sm, Mm, Gll^Fmw, Gll^Fmw, Gll^Fmw, Gg, Gg, Gg, Gg, Gg, Rp, Rp, Rp, Gg^Efm, Gg, Gll^Fmw, Gll^Fmw, Mm, Hh, Hh, Dd, Dd, Dd, Dd, Dd, Dd, Dd, Dd, Dd, Dd, Dd, Dd, Dd, Dd, Dd, Dd, Dd, Dd, Dd^Ftd, Dd^Ftd, Dd, Dd, Dd
Mm, Rp, Rp, Kfr, Mm, Gll^Fmw, Gg, Gg, Gg, Gg, Gg, Gg, Gg, Gg, Gg^Efm, Gg^Efm, Ww^Ewl, Gg^Fet, Gll^Fmw, Gg^Fet, Hh, Hh, Hh, Dd, Dd, Ke, Dd, Dd, Gs^Ftp, Dd^Ftd, Dd^Ftd, Dd, Dd, Dd, Dd, Dd, Gd^Fetd, Dd, Ke, Dd, Gs^Ftp, Dd, Gd^Fetd, Dd, Dd, Dd
Mm, Mm, Gg^Fet, Mm, Mm, Gg, Gg, Gg, Gg, Gg^Fet, Gg, Gg, Gg, Gg, Gg^Efm, Gg^Efm, Ww^Ewl, Ww^Ewl, Gg^Fet, Gg^Fet, Mm, Mm, Dd, Dd, Ke, Dd, Dd, Dd, Gs^Ftp, Dd^Do, Dd^Ftd, Dd, Dd, Dd, Dd, Dd, Dd, Gll^Feth, Gll^Feth, Dd, Gs^Ftp, Ke, Gd^Fetd, Gd^Fetd, Dd, Dd
Mm, Mm, Mm, Aa^Voa, Rp, Gg, Gg, Gg, Rp, Gg, Gg, Gg, Aa^Bsb/, Cfr, Gg^Efm, Gg, Ww^Ewl, Ww^Ewl, Gg^Fet, Hh, Hh, Mm, Hh, Dd, Dd, Dd, Dd, Dd, Dd, Dd, Dd, Dd, Dd, Ke, Dd, Dd, Dd, Dd, Gll^Fmf, Gd^Fetd, Dd^Ftd, Dd^Ftd, Dd^Ftd, Gll^Fmf, Dd, Dd
Mm, Gg^Fet, Gg, Mm, Rp, Gg, Gg, Rp, Aa^Vea, Rp, Gg, Gg, Gg, Gg, Gg^Efm, Ww^Ewl, Ww^Ewl, Ww^Ewl, Gg^Fet, Gg^Fet, Hh, Mm, Dd, Dd, Dd, Cd, Dd, Dd, Dd, Dd, Dd, Dd, Gll^Fdf, Dd, Dd, Ke, Dd, Dd, Gll^Fmf, Gll^Fmf, Dd^Ftd, Dd^Do, Dd^Ftd, Uue, Dd, Dd
Rp, Mm, Rp, Gg, Gg, Gg, Gg, Rp, Rp, Rp, Gg, Gg, Gg, Gg, Gg, Gg^Efm, Gg^Fet, Gg^Fet, Gg, Gg, Mm, Hh, Mm, Dd, Dd, Dd, Dd, Dd, Dd, Gll^Fdf, Gll^Fdf, Gll^Fdf, Gll^Fdf, Dd, Dd, Dd, Dd, Dd, Dd, Gll^Fmf, Gll^Fdf, Dd^Ftd, Uue, Uue, Dd, Dd
Rp, Rp, Rp, Gg, Gg^Fet, Gg, Gg, Gg, Gg, Gg, Rp, Gg, Gg, Gg, Gg, Gg, Gg, Gg, Gg, Gg, Mm, Kme, Mdd^Xm, Mdd^Xm, Dd, Ke, Gs^Ftp, Dd^Do, Dd^Ftd, Gd^Fts, Gd^Fetd, Gll^Feth, Gll^Feth, Gd^Fetd, Gd^Fetd, Dd, Dd, Dd, Gll^Fdf, Gll^Fmf, Gll^Fdf, Dd, Ke, Dd, Dd, Dd
Gg, Rp, Gg, Kh, Gg, Gg, Gg, Gg, Gg, Gg, Rp, Rp, Rp, Gg, Gg, Gg, Gg, Gg, Gg, Gg, Gg, Mm, Dd, Dd, Dd, Dd, Gs^Ftp, Dd^Ftd, Gd^Fts, Gll^Feth, Gll^Feth, Ke, Gd^Fetd, Gd^Fetd, Dd, Gll^Fdf, Dd, Dd, Dd, Dd, Dd, Dd, Dd, Dd, Dd, Dd
Gg, Gg, Gg, Qxu^Bs|, Gg, Gs^Fms, Gs^Fms, Gs^Fms, Gg, Gg, Rp, Kv, Rp, Gg, Gg, Gg^Fet, Gg, Gg, Gg, Gg, Gg, Mdd^Xm, Sm, Dd, Sm, Dd, Dd, Dd, Dd, Gll^Feth, Gd^Fetd, Gd^Fetd, Dd^Ftd, Dd^Ftd, Gs^Ftp, Dd, Xu, Dd, Sm, Dd, Dd, Dd, Dd, Dd, Dd, Dd
Gg, Gg^Fet, Gg, Gg, Gg, Gs^Fms, Gs^Fms, Gs^Fms, Gs^Fms, Gg, Gg, Rp, Rp, Gg, Gg, Gg, Gg, Gg, Gg, Gg, Hh, Mm, Sm, Rr^Vhc, Sm, Sm, Sm, Sm, Sm, Gd^Fetd, Xu, Dd^Ftd, Xu, Dd^Do, Xu, Xu, Sm, Sm, Sm, Sm, Sm, Sm, Sm, Sm, Dd, Dd
Gd, Gg, Gd, Gg, Gd, Gs^Fms, Gd, Gs^Fms, Gd, Gg, Gd, Gg, Gd, Gg, Gd, Gg, Gd, Gd, Gd, Gd, Hh, Mm, Uhe, Sm, Uhe, Sm, Sm, Sm, Sm, Sm, Sm, Xu, Sm, Xu, Sm, Sm, Rr^Vhc, Sm, Sm, Sm, Sm, Sm, Sm, Sm, Dd, Dd
Gd, Gd, Gd, Gd, Gd, Gd, Gd, Gd, Gd, Gd, Gd, Gd, Gd, Gd, Gd, Gd, Gd, Gd, Gd, Gd, Hh, Mm, Uhe, Uhe, Sm, Uhe, Uhe, Uhe, Sm, Sm, Sm, Sm, Sm, Sm, Sm, Sm, Sm, Sm, Sm, Sm, Sm, Sm, Sm, Sm, Sm, Dd
Gg, Gd, Gg^Esa, Gd, Gg^Esa, Gg^Esa, Gg^Esa, Gg^Esa, Gg^Esa, Ss, Gg^Esa, Gll, Gll^Bw/r, Gg, Gll, Gg, Gg, Gg^Esa, Gg, Gg, Qxe, Mm, Sm, Sm, Sm, Ql, Uhe, Mv, Uhe, Uhe, Sm, Sm, Sm, Sm, Sm, Sm, Sm, Sm, Sm, Sm, Sm, Sm, Sm, Sm, Sm, Dd
Gg, Gll, Gg, Gg^Esa, Gg, Gg, Gll, Gg^Esa, Ss, Ss, Ww^Bw/r, Ss^Bw/r, Gg, Gll, Gll, Gg, Gg, Gg, Gg, Gll, Gll, Mm, Sm, Sm, Mv, Uhe, Sm, Uhe, Sm, Sm, Sm, Sm, Sm, Sm, Sm, Sm, Sm, Sm, Sm, Sm, Sm, Sm, Ql, Sm, Sm, Sm
Gg, Gg^Gvs, Gg, Chs, Rrc, Gg, Gg, Gg, Gg^Bw/r, Ww^Bw/r, Gg^Esd, Ss, Gs^Fds, Gs^Fds, Gs^Fds, Gs^Fds, Gg, Gll, Gg, Gll, Hhd, Mm, Uhe, Uhe, Sm, Sm, Sm, Sm, Sm, Sm, Sm, Sm, Sm, Sm, Sm, Sm, Sm, Sm, Sm, Sm, Sm, Sm, Sm, Sm, Sm, Sm
Gg, Gg^Gvs, Gg, Rrc, Gg^Gvs, Rrc, Rrc, Rrc, Ss, Ww^Ewl, Ww^Ewl, Gg, Gg, Gg, Gg, Gs^Fds, Gll, Gll, Gll, Gll, Mm, Mm, Uhe, Rr^Vhc, Sm, Sm, Sm, Sm, Sm, Sm, Sm, Sm, Sm, Sm, Sm, Sm, Sm, Sm, Sm, Sm, Sm, Sm, Sm, Sm, Sm, Sm
Gg, Gg^Gvs, Gg, Rrc, Gg^Gvs, Gg^Gvs, Gg^Gvs, Rrc, Rrc, Ss, Gg^Esd, Gg^Esd, Gg, Gs^Vh, Gg^Edp, Gg, Gll, Gg, Gg, Gll, Mm, Mm, Uue, Mm, Mm, Sm, Sm, Sm, Sm, Sm, Sm, Sm, Sm, Sm, Sm, Sm, Kud, Sm, Sm, Sm, Sm, Sm, Sm, Sm, Kud, Uhe
Gg, Gg^Dr, Gg^Gvs, Rrc, Gg^Gvs, Gg^Dr, Gg^Gvs, Gg^Gvs, Gg, Rrc^Esd, Rrc, Gg^Esd, Gg, Gll, Gg, Gg, Gg, Gg, Cv, Mm, Hhd, Mm, Uhe, Mm, Uue, Uue, Rr^Vhc, Sm, Sm, Sm, Sm, Sm, Sm, Sm, Sm^Bsb/, Sm^Bsb/, Sm, Sm^Bsb\, Sm^Bsb\, Sm, Rb, Sm, Sm^Bsb/, Sm^Bsb/, Uue, Uhe
Gg, Gg^Gvs, Gg, Rrc, Gg^Gvs, Gs^Fds, Gg^Gvs, Gg^Fet, Gg, Gg^Gvs, Gg^Gvs, Rrc, Rrc, Gg, Gg^Gvs, Gg, Rrc, Rrc, Hhd, Hhd, Hhd, Mm, Uhe, Uhe, Mm, Mm, Mm, Sm, Sm, Sm, Sm, Sm, Sm^Bsb/, Sm^Bsb/, Sm, Sm, Sm, Sm, Sm, Sm^Bsb\, Sm^Bsb/, Sm^Bsb/, Sm^Bsb/, Sm^Bsb/, Sm, Uhe
Gg, Gg^Fet, Gg^Gvs, Rrc^Esd, Gg^Gvs, Gs^Fds, Gg^Gvs, Gg^Gvs, Rp, Gs^Vht, Rp^Gvs, Gg^Fet, Rp, Rrc, Rrc, Rrc, Gg^Gvs, Gg, Hhd, Hhd, Hhd, Md, Qlf, Qxe, Qlf, Uue, Uhe, Sm, Sm, Sm, Sm^Bsb/, Sm, Sm, Rr^Vhc, Sm, Sm, Sm, Sm, Sm^Bsb/, Sm^Bsb/, Sm, Sm^Bsb/, Sm, Sm, Uhe, Sm
Gg, Gg^Gvs, Gg^Gvs, Rrc, Rp, Rp^Gvs, Rp, Rp^Esd, Gg^Gvs, Rp, Gg^Gvs, Rp, Rp, Rrc, Gs^Vht, Gg^Gvs, Gg, Gg, Hhd, Hhd, Hhd, Mm, Md, Qlf, Uue, Qlf, Uhe, Sm, Sm, Sm^Bsb/, Sm, Sm, Sm, Sm, Sm, Sm, Sm^Bsb/, Sm^Bsb/, Sm, Sm, Sm, Sm, Sm, Sm, Uhe, Sm
Gg, Gg^Gvs, Rp, Gs^Vht, Rp, Rp, Gll, Gg^Gvs, Gg^Gvs, Gg, Rp, Rp, Rp, Rp, Gg^Gvs, Rp, Rp, Gg^Ve, Hhd, Hhd, Qlf, Mm, Mv, Uue, Ql, Qlf, Uue, Sm, Sm, Sm, Sm, Sm, Sm, Sm, Sm^Bsb/, Sm^Bsb/, Sm, Sm, Sm, Uhe, Uhe, Sm, Uhe, Uhe, Sm, Sm
Gg^Gvs, Gg, Gg^Gvs, Rp, Rp, Gll, Gll, Gs^Vh, Rp, Rp, Rp, Kvr, Gll, Gg^Gvs, Gg, Gll, Rp, Gg, Hhd, Hhd, Md, Mm, Md, Uue, Qlf, Qlf, Uue, Sm, Rr^Vhc, Sm, Sm, Sm^Bsb/, Sm^Bsb/, Kud, Sm, Sm, Sm, Sm, Sm, Uhe, Uhe, Uhe, Uhe, Uhe, Sm, Sm
Gg, Gg^Gvs, Rp, Rp, Rp, Kv, Gll, Gg^Gvs, Gg^Fet, Gg^Gvs, Gg^Gvs, Rp, Gll, Gg, Gll, Gg, Rrc, Gg, Hhd, Qlf, Hh, Mm, Mv, Uue, Qlf, Kud, Sm, Sm, Sm, Sm, Sm, Sm^Bsb/, Sm, Sm, Sm, Sm, Sm, Sm, Sm, Uhe, Uhe, Uhe, Uhe, Uhe, Sm, Sm
Gg, Gg^Vwm, Rp, Rp, Gg^Gvs, Gg^Gvs, Gg^Gvs, Gg^Gvs, Gg^Edb, Gg^Gvs, Gg^Gvs, Rp, Rp, Rrc, Rrc, Gg, Rrc, Gg, Hhd, Hhd, Mm, Mm, Uhe, Uue, Mv, Qlf, Sm, Sm, Sm, Sm, Sm, Sm, Sm, Sm, Sm, Sm, Sm, Sm, Uhe, Uhe, Uhe, Sm, Uhe, Sm, Sm, Sm
Gg, Gg^Gvs, Gg^Gvs, Gg, Gg^Gvs, Gg^Fet, Gs^Fds, Gg^Fet, Gs^Fds, Gg^Fet, Gs^Fds, Gg^Gvs, Gg^Gvs, Gg, Gg, Cv, Gg, Gg, Gg, Hhd, Md, Mm, Mm, Uue, Mv, Qlf, Sm, Sm, Sm, Sm, Sm, Sm, Sm, Sm, Sm, Uhe, Uhe, Uhe, Sm, Rr^Vhc, Uhe, Sm, Sm, Uhe, Sm, Sm
Gg^Gvs, Gg^Gvs, Gg^Gvs, Gg^Gvs, Gg^Fet, Gg^Fet, Gg^Fet, Gg^Fet, Gg^Fet, Gs^Fds, Gg^Gvs, Gg^Gvs, Gg, Gg, Urc, Rrc, Rp, Gg, Gd^Vo, Hhd, Hh, Mm, Uhe, Uue, Uue, Qlf, Qlf, Sm, Sm, Sm, Uhe, Sm, Uhe, Uhe, Uhe, Uhe, Uhe, Sm, Sm, Sm, Uhe, Uhe, Sm, Sm, Sm, Sm
Gg^Gvs, Gg^Gvs, Gg^Gvs, Gg^Fet, Gg^Gvs, Gs^Fds, Gg^Fet, Gg^Fet, Gg^Gvs, Gg^Gvs, Gg^Gvs, Gg^Vwm, Rp, Rp, Rp, Gg, Rp, Rp, Hhd, Hhd, Md, Mm, Ql, Uue, Uue, Uue, Qlf, Uhe, Uhe, Uhe, Uhe, Uhe, Uhe, Uhe, Uhe, Uhe, Sm, Sm, Sm, Uhe, Sm, Sm, Sm, Sm, Sm, Sm
Gg, Gg^Gvs, Gg^Gvs, Gg^Gvs, Gg^Gvs, Gg^Gvs, Gg, Gg^Gvs, Gg^Gvs, Gg^Gvs, Gg, Gg, Gg, Gg, Gg, Rp, Gg, Gg, Gg, Hhd, Gg, Mm, Gg, Sm, Gg, Sm, Gg, Sm, Gg, Sm, Sm, Sm, Sm, Uhe, Gg, Sm, Gg, Sm, Gg, Sm, Gg, Sm, Gg, Sm, Sm, Sm
