Ha, Ha, Ha, Ha, Ha, Ha, Aa, Ha, Ha, Ha, Ha, Ha, Ha, Ha, Ha^Vhha, Ha, Ha, Ha, Ha, Ha, Ha, Gg, Ms, Ias, Gd, Gd, Gd, Gd, Ias, Ias, Ias, Ias, Ias, Dd, Cte, Ias, Ias, Ias, Ias, Ias, Ias, Ias, Ias, Ias, Ias, Ias
Ha, Ha, Ss^Vhs, Rra, Ha, Aa, Ha, Aa, Ha, Aa, Ss^Vhs, Ha, Rra, Rra, Aa, Aa, Aa, Ha, Ha, Ha, Ms, Ms, Ha, Gd^Esa, Gd, Gd, Ias, Gd, Gd^Fetd, Gd, Gd, Gd, Gd^Fetd, Cud, Ias, Ias, Ias, Ias, Ias, Ias, Ias, Ias, Ias, Ias, Ias, Ias
Ha, Ha, Ha, Rra, Ha, Ha, Cme, Aa, Ha, Aa, Gg, Rra, Ss^Vhs, Aa^Feta, Aa^Feta, Aa, Aa, Kva, Ha, Ha, Ha, Ms, Mdd^Xm, Gd, Ias, Cf, Cud, Cf, Gd^Fetd, Gd, Gd, Gd, Gd, Gd^Fetd, Ias, Ias, Ias, Ias, Ias, Ias, Ias, Ias, Ias, Ias, Ias, Ias
Ha, Aa^Feta, Aa, Ha, Aa, Cme, Ha, Cme, Cme, Aa, Aa, Rra, Rra, Aa^Feta, Aa, Aa, Gll^Ftr, Qxu^Bcx|, Ss^Vhs, Gll^Ftr, Ha, Ms, Ha, Gd, Ias, Cf, Ias, Cf, Gll^Fmf, Gd^Fetd, Gd^Vhr, Gd, Gd, Gd^Fetd, Gd^Fetd, Ias, Ias, Ias, Ias, Ias, Ias, Ias, Gd^Vhr, Ias, Ias, Ias
Ha, Aa, Aa, Aa, Gll^Ftr, Gll^Ftr, Ha, Kh, Qxu^Bs\, Aa, Aa, Aa, Rra, Gll^Ftr, Gll^Ftr, Aa, Rra^Yl, Rra, Rra, Gll^Ftr, Ha, Ms, Ms, Gd^Esa, Ias, Ias, Ias, Ias, Gll^Fmf, Gd^Fetd, Gd, Gd, Cf, Ias, Gd^Fetd, Gd, Gd, Ias, Ias, Ias, Gd, Ias, Ias, Ias, Ias, Ias
Ha, Ha, Ha, Aa, Gll^Ftr, Gll^Ftr, Gll^Ftr, Ha, Gll^Ftr, Aa, Ww^Ewl, Gll^Ftr, Rra, Hhd^Vhhr, Rra^Yl, Rra^Yl, Rra^Yl, Rra^Yl, Ww^Ewl, Ww^Ewl, Ha, Ms, Ha, Ms, Gd, Ias, Ias, Ias, Ias, Gd^Fetd, Ias, Cf, Cud, Cf, Ias, Gd^Fetd, Gd, Gd, Gd, Gd, Gd, Gll^Fmf, Gll^Fmf, Ias, Ias, Ias
Ha, Ss^Vhs, Rra, Aa, Ha, Gll^Ftr, Gll^Ftr, Gll^Ftr, Ww^Ewl, Ww^Ewl, Gll^Ftr, Gll^Ftr, Gll^Ftr, Rra, Rra^Yl, Rra^Yl, Ww^PsgS, Ww^Ewl, Gll^Ftr, Gll^Ftr, Ms, Ha, Ha, Gd^Esa, Ias, Ias, Ias, Ias, Ias, Ias, Ias, Cf, Cf, Cf, Ias, Gd^Fetd, Gll^Fmf, Gll^Fmf, Gll^Fmf, Gll^Fmf, Gll^Fmf, Gd^Fetd, Gll^Fmf, Gd, Gd, Ias
Ha, Rra, Qxu^Bh/, Chs, Ha, Gll^Ftr, Ww^Ewl, Ww^Ewl, Ww^Ewl, Gll^Ftr, Gll^Ftr, Gll^Ftr, Gll^Ftr, Gll^Ftr, Ww^Ewl, Ww^Ewl, Gll^Ftr, Aa^Feta, Gll^Ftr, Aa^Feta, Ha, Ha, Ha, Ias, Ias, Gd^Vhr, Gd, Ias, Gll^Fdf, Gll^Fdf, Gll^Fdf, Ias, Ias, Ias, Ias, Ias, Gd^Fetd, Gll^Fmf, Gd^Vhr, Gll^Fmf, Gll^Fmf, Gll^Fmf, Gd^Fetd, Gd, Gd, Gd
Ha, Ha, Aa^Feta, Ha, Ha, Ww^Ewl, Ww^Ewl, Ww^Ewl, Aa, Aa^Feta, Ww^Ewl, Kme, Cva, Kme, Ww^Vm, Ww^Ewl, Gll^Ftr, Gll^Ftr, Aa^Feta, Aa^Feta, Ms, Ms, Gd^Esa, Ias, Gd^Vhr, Gll^Fmf, Gd, Ias, Gll^Fdf, Gll^Fdf, Gll^Fdf, Ias, Ias, Ias, Ias, Ias, Ias, Gll^Feth, Gll^Feth, Gll^Fmf, Gs^Ftp, Gd^Vhr, Gd^Fetd, Gd^Fetd, Gd, Gd
Ha, Ha, Ha, Ss^Vhs, Rra, Ww^Ewl, Ww^Ewl, Aa, Rra, Aa, Ww^Ewl, Aa, Aa^Bsb/, Khs, Kme, Ww^Ewl, Gll^Ftr, Gll^Ftr, Aa^Feta, Ha, Ha, Ms, Ha, Ias, Ias, Gd, Gd, Gll^Fdf, Gll^Fdf, Gll^Fdf, Gll^Fdf, Ias, Ias, Gg, Ias, Ias, Ias, Ias, Gll^Fmf, Gd^Fetd, Gll^Fdf, Gll^Fdf, Gll^Fdf, Gll^Fmf, Gd, Gd
Ha, Aa^Feta, Ww^Ewf, Ha, Ww^Ewf, Ww^Ewl, Ww^Ewl, Rra, Ss^Vhs, Rra, Ww^Ewl, Aa, Ww^Ewl, Ww^Ewl, Kme, Gll^Ftr, Gll^Ftr, Gll^Ftr, Aa^Feta, Aa^Feta, Ha, Ms, Gd, Ias, Cf, Cud, Cf, Gll^Fdf, Gll^Fdf, Gll^Fdf, Gll^Fmf, Ias, Gll^Fdf, Ias, Ias, Ias, Ias, Ias, Gll^Fmf, Gll^Fmf, Gll^Fdf, Gll^Fdf, Gll^Fdf, Uue, Gd, Gd
Aa, Ha, Rra, Ww^Ewf, Ww^Ewf, Ww^Ewl, Ww^Ewf, Rra, Rra, Rra, Ww^Ewl, Ww^Ewl, Ww^Ewl, Ww^Ewl, Ww^Ewl, Aa, Aa^Feta, Aa^Feta, Ww^Ewl, Ww^Ewl, Ms, Ha, Ms, Gd, Ias, Gd, Gd, Gd, Gll^Fmf, Gll^Fdf, Gll^Fdf, Gll^Fdf, Gll^Fdf, Ias, Ias, Ias, Ias, Ias, Ias, Gll^Fmf, Gll^Fdf, Gll^Fdf, Gll^Fdf, Gll^Fdf, Gd, Gd
Ww^Ewf, Ww^Ewf, Ww^Ewf, Aa, Aa^Feta, Ww^Ewf, Ww^Ewl, Ww^Ewl, Ww^Ewl, Ww^Ewl, Ww^Ewl, Ww^Ewl, Ww^Ewl, Ww^Ewl, Ww^Ewl, Ww^Ewl, Ww^Ewl, Ww^Ewl, Ww^Ewl, Ww^Ewl, Ms, Kme, Mdd^Xm, Mdd^Xm, Gd, Gd^Vhr, Gll^Fdf, Gll^Fdf, Gll^Fdf, Gll^Fdf, Gd^Fetd, Gll^Feth, Gll^Feth, Gd^Fetd, Gd^Fetd, Ias, Ias, Ias, Gll^Fdf, Gll^Fmf, Gll^Fdf, Ias^Edp, Rp, Dd, Wwf, Gd
Ww^Ewf, Rra, Ww^Ewf, Kh, Ww^Ewf, Ww^Ewf, Ww^Ewf, Ww^Ewf, Ww^Ewf, Ww^Ewf, Rra, Rra, Rra, Ww^Ewl, Ww^Ewl, Ww^Ewl, Ww^Ewl, Ww^Ewl, Ww^Ewl, Ww^Ewl, Ww^Ewl, Mm, Sm, Gd, Rb, Gd, Gll^Fdf, Gll^Fdf, Gll^Fdf, Gll^Feth, Gll^Feth, Gd, Gd^Fetd, Gd^Fetd, Gd, Gll^Fdf, Ias, Ias, Gd, Gd, Sm, Ias, Sm, Dd, Wwf, Xu
Ww^Ewf, Ww^Ewf, Ww^Ewf, Qxu^Bs|, Ww^Ewf, Ss, Ss, Ss, Ww^Ewf, Ww^Ewf, Rra, Cm, Ww^Ewl, Ww^Ewl, Ww^Ewl, Aa^Feta, Ww^Ewl, Ww^Ewl, Ww^Ewl, Ww^Ewl, Ww^Ewl, Mdd^Xm, Sm, Sm, Rb, Sm, Rb, Sm, Sm, Gll^Feth, Gd^Fetd, Gd^Fetd, Sm, Sm, Sm, Gd, Sm, Sm, Sm, Sm, Sm, Sm, Sm, Sm, Wwrt, Xu
Ww^Ewf, Aa^Feta, Ss, Ss, Ww^Ewf, Ss, Ss, Ss, Ss, Ww^Ewf, Ww^Ewf, Rra, Rra, Ww^Ewl, Ww^Ewl, Ww^Ewl, Ww^Ewl, Ww^Ewl, Ww^Ewl, Ww^Ewl, Ha, Mm, Wwf, Rr^Vhc, Rb, Rb, Rb, Sm, Sm, Sm, Sm, Sm, Sm, Sm, Rb, Sm, Wwt, Sm, Sm, Sm, Wwf, Sm, Wwt, Wwr, Xu, Xu
Gg^Esa, Ww^Ewf, Gg^Esa, Ss, Gg^Esa, Ss, Gg, Ss, Gg, Ww^Ewf, Gg^Esa, Ww^Ewf, Gg^Esa, Ww^Ewl, Gg^Esa, Ww^Ewl, Ww^Ewl, Ww^Ewl, Gg^Esa, Gg^Esa, Hh, Mm, Wwf, Gs, Ww, Wwf, Wwg, Wwf, Wwf, Sm, Wwf, Wwf, Wwf, Rb, Rb^Efm, Wwt, Rr^Vhc, Rb^Efm, Wwt, Wwf, Wwf, Wwf, Wwr, Wwr, Wwr, Xu
Gg, Gg^Esa, Gg, Gg^Esa, Gg^Esa, Gg^Esa, Gg^Esa, Gg^Esa, Gg^Esa, Gg^Esa, Gg, Gg^Esa, Ur, Gg^Esa, Ur, Gg^Esa, Gg, Gs^Vht, Gg^Esa, Gg^Esa, Hh, Mm, Wwf, Wwt^Bsb|, Ww, Ww, Wwg, Ww, Ww, Ww, Ww, Wwt, Wwt, Rb, Wwt, Rb^Efm, Rb, Rb, Wwt, Wwt, Wwt, Wwr, Wwrg, Wwr, Xu, Xu
Ur, Ur, Ur, Ur, Gg, Gg^Esa, Ur, Ur, Ur, Wwt, Gg, Ur, Gll^Bw/r, Gg, Gll, Ur, Ur, Gg^Esa, Ur, Gg, Hh, Mm, Wwf, Wwt^Bsb|, Ww, Ww, Wwg, Ww, Ww, Ww, Ww, Wwg, Wwg, Wwt, Rb, Rb, Wwt, Wwt, Wwt, Wwt, Wwt, Wwt, Wwrg, Wwrg, Xu, Xu
Ur, Ur, Ur, Ur, Irs, Ur, Gll, Ur, Gg, Wwt, Ww^Bw/r, Wwt^Bw/r, Gg, Gll, Gll, Gg, Ur, Ur, Ur, Gll, Hh, Mm, Wwt, Ww^Bsb|, Ww, Ww, Ww, Wwg, Ww, Ww, Wwg, Wwg, Ww, Wwg, Wwt, Wwt^Bsb\, Wwt^Bsb\, Wwt, Wwt, Wwt, Wwt, Wwt, Wot, Wwrg, Wwrt, Xu
Ur, Ur, Ur, Kf, Rrc, Irs, Irs, Gg, Gg, Ww^Bw/r, Ur, Wwt, Gll^Fdw, Gll^Fdw, Gll^Fdw, Gs^Fds, Gg, Ur, Ur, Ur, Hhd, Mm, Wwt, Gs, Gs, Wwg, Ww, Wwg, Ww, Wwg, Ww, Ww, Ww, Ww, Wwt, Wwt, Wwt, Wwt^Bsb\, Wwt^Bsb\, Wwt, Wwt, Wwt, Wwt, Wwrg, Xu, Xu
Gg, Ur, Ur, Ur, Ur, Ur, Ur, Ur, Irs, Wwt, Wwt, Gg, Gg, Gg, Gg, Gll^Fdw, Gll, Ur, Ur, Ur, Mm, Mm, Wwt, Rr^Vhc, Wwt, Wwt, Wwt, Wwg, Wwg, Ww, Ww, Ww, Ww, Wwt, Ww, Ww, Wwt, Wwt, Wwt, Wwt^Bsb\, Wwt^Bsb\, Cme, Cme, Wwt, Wwr, Xu
Gg, Gll^Fdw, Gll^Fdw, Rrc^Edb, Gg^Gvs, Gll^Fdw, Gll^Fdw, Ur, Ur, Irs, Irs, Gg, Gg, Gg^Ve, Gg^Edp, Gg, Gg, Ur, Ur, Ur, Mm, Mm, Wwt, Mm, Mm, Wwt, Rb, Wwt, Ww, Ww, Ww, Ww, Ww, Ww, Wwg, Wwg, Kh, Wwt, Wwt, Wwt, Rb, Km, Rb, Wwt, Ww, Wwrt
Gg, Xof, Gll^Fdw, Gll^Fdw, Gll^Fdw, Xof, Gll^Fdw, Gll^Fdw, Gll^Fdw, Ur, Ur, Irs, Irs, Gll, Irs, Gg, Irs, Irs, Cv, Mm, Hhd, Mm, Wwt, Mm, Wwt, Uue, Rr^Vhc, Wwg, Ww, Wwg, Wwg, Ww, Wwg, Wwg, Sm^Bsb/, Sm^Bsb/, Rb^Gvs, Sm^Bsb\, Sm^Bsb\, Rb, Wwt, Wwt, Sm^Bsb/, Rb, Wwrt, Wwrt
Gll^Fdw, Gll^Fdw, Gll^Fdw, Ur, Gll^Fdw, Gll^Fdw, Gll^Fdw, Gll^Fdw, Ur, Ur, Gll^Fdw, Ur, Ur, Irs, Irs, Irs, Rrc, Rrc, Ur, Hhd, Hhd, Mm, Wwt, Uhe, Mm, Mm, Mm, Gs, Ww, Wwg, Wwg, Wwg, Sm^Bsb/, Sm^Bsb/, Rb^Gvs, Rb^Gvs, Gs, Rb^Gvs, Rb^Gvs, Rb, Sm^Bsb/, Sm^Bsb/, Wwt, Wwt, Wwrg, Wwrt
Gll^Fdw, Gll^Fdw, Gll^Fdw, Rrc^Esd, Ur, Gll^Fdw, Ur, Ur, Ur, Gg^Ve, Rp^Gvs, Gg^Fet, Rd, Rrc^Edb, Rrc, Rrc, Irs, Irs, Hhd, Hhd, Hhd, Md, Wwt, Wwt, Wwt, Wwt, Wwt, Wwt^Bsb|, Ww, Wwg, Wot, Rb, Rb^Gvs, Rr^Vhc, Rb^Gvs, Rb^Gvs, Gs, Gs, Sm^Bsb/, Sm^Bsb/, Ww, Wwt, Ww, Ww, Wwrt, Wwrt
Ur, Ur, Ur, Rrc, Rp, Rp^Gvs, Rp, Gll^Fdw, Gll^Fdw, Rp, Gll^Fdw, Rp, Rp, Rrc^Edb, Gg^Ve, Irs, Irs, Irs, Hhd, Hhd, Hhd, Mm, Md, Wwt, Wwt, Ww, Ww, Ww^Bsb|, Wog, Wot, Rb, Gs, Rb^Gvs, Rb^Gvs, Rb^Gvs, Gs, Sm^Bsb/, Sm^Bsb/, Ww, Ww, Ww, Ww, Ww, Ww, Wwrt, Wwrt
Ur, Ur, Ur, Gg^Ve, Rp, Rp, Gd, Gll^Fdw, Gll^Fdw, Gg, Cv, Cv, Rp, Rp, Irs, Ur, Ur, Gg^Ve, Hh, Hhd, Hh, Mm, Wwt, Wwt, Wwt, Wwt, Wwt, Wog^Bsb|, Rb, Rb, Rb^Gvs, Rb^Gvs, Ch, Ch, Cme, Sm^Bsb/, Ww, Ww, Ww, Ww, Wot, Ww, Ww, Ww, Wwrt, Wwrt
Ur, Ur, Ur, Ur, Rp, Gd, Irs, Gg^Ve, Rp, Rp, Ur, Kvr, Cv, Irs, Irs, Irs, Irs, Irs, Ur, Hh, Md, Mm, Md, Wwt, Cme, Cme, Ch, Wog^Bsb|, Rb, Wog, Rb, Rb^Gvs, Cme, Km, Cme, Ww, Ww, Ww, Ww^Ii, Ww, Wot, Ww, Ww, Ww, Wwrt, Wwrt
Ur, Ur, Rp, Rp, Irs, Kv, Ur, Ur, Gll^Fdw, Ur, Ur, Ur, Irs, Cv, Cv, Irs, Irs, Irs, Ur, Ur, Hh, Mm, Wwt, Gs, Gs, Kh, Rb, Rb, Wog, Wog^Bsb\, Rb, Sm^Bsb/, Ww, Cme, Ww, Ww^Bsb\, Ww^Bsb\, Ww^Ii, Ww, Ww, Ww, Ww, Ww, Ww, Wot, Wwrt
Gg, Gg^Ve, Irs, Irs, Ur, Gll^Fdw, Ur, Ur, Gll^Fdw, Gll^Fdw, Ur, Irs, Irs, Irs, Irs, Cv, Irs, Irs, Ur, Ur, Mm, Mm, Wwt, Wwt, Gs, Gs, Ww, Wog, Wog^Ii, Wog, Wog, Ww, Wot, Wot^Ii, Wot, Ww^Ii, Ww, Ww^Bsb\, Rb, Rb, Uhe, Ww, Ww, Wot, Wwrt, Wwrt
Gg, Gg^Gvs, Gg^Gvs, Gg, Gll^Fdw, Gll^Fdw, Gll^Fdw, Gll^Fdw, Gll^Fdw, Gll^Fdw, Gll^Fdw, Ur, Irs, Irs, Irs, Kf, Irs, Irs, Irs, Ur, Md, Mm, Mm, Rr^Vhc, Wwt, Ww, Ww, Ww, Ww, Wog^Ii, Wog, Ww^Ii, Wot, Wot^Ii, Ww, Ww^Ii, Ww, Ww, Rb^Gvs, Rr^Vhc, Ww, Ww, Ww, Wot, Wwrg, Wwrt
Gg^Gvs, Gg^Gvs, Gg^Gvs, Gg^Gvs, Gll^Fdw, Gll^Fdw, Gll^Fdw, Gll^Fdw, Gll^Fdw, Gll^Fdw, Gg^Gvs, Gg^Gvs, Ur, Irs, Irs, Irs, Irs, Irs, Gg^Ve, Ur, Hh, Mm, Wwt, Wwt, Ww, Ww, Wwt, Ww, Ww, Wog, Ww, Ww, Ww, Ww, Ww^Ii, Ww, Ww, Ww, Ww, Rb^Gvs, Ww, Wot, Ww, Wwrg, Wwrt, Wwrt
Gg^Gvs, Gg^Gvs, Gg^Gvs, Gll^Fdw, Gg^Gvs, Gll^Fdw, Gll^Fdw, Gll^Fdw, Gg^Gvs, Gg^Gvs, Gg^Gvs, Gg^Ve, Rp, Irs, Irs, Irs, Irs, Irs, Ur, Ur, Md, Mm, Wwt, Wwt, Ww, Ww, Ww, Ww, Ww, Ww, Ww, Ww, Ww, Ww, Ww, Ww, Wwr, Ww, Ww, Wwr, Ww, Wot, Ww, Wwrt, Wwrt, Wwrt
Gg, Gg^Gvs, Gg^Gvs, Gg^Gvs, Gg^Gvs, Gg^Gvs, Gg, Gg^Gvs, Gg^Gvs, Gg^Gvs, Gg, Gg, Gg, Ur, Gg, Rp, Gg, Gg, Gg, Ur, Gg, Mm, Gg, Wwr, Gg, Ww, Gg, Ww, Gg, Ww, Sm, Ww, Ww, Ww, Ww, Ww, Ww, Ww, Ww, Ww, Ww, Ww, Gg, Wwrt, Sm, Wwrt
