Hh, Hh, Hh, Hh, Hh, Ww^Ewf, Ww^Ewf, Re, Re, Re, Re, Re, Re, Re, Hh, Hh, Hh, Hh, Hh, Hh, Hh, Gg, Mm, Ias, Gd, Gd, Gd, Gd, Gd, Gd, Gd, Gd, Gd, Gd, Gd, Gd, Gd, Gd, Gd, Gd, Gd, Gd, Gd, Gd, Gd, Gd
Hh, Hh, Hh^Vhh, Rr, Hh, Ww^Ewf, Re, Ww^Ewf, Re, Ww^Ewf, Ss^Vhs, Re, Rr, Rr, Ww^Ewl, Ww^Ewl, Ww^Ewl, Hh, Hh, Hh, Mm, Mm, Hhd, Gd, Gd, Gd, Ias, Gd, Gd^Fetd, Gd, Gd, Gd, Gd^Fetd, Gd, Gd, Gd, Gd, Gd, Gd^Vhr, Gd, Gd, Gd, Gd, Gd, Gd, Gd
Hh, Hh, Rp, Rr, Hh, Hh, Cme, Ww^Ewf, Re, Re, Re, Rr, Ss^Vhs, Re, Re, Ww^Ewl, Ww^Ewl, Kv, Hh, Hh, Hh, Mm, Mm, Gd, Gd, Cf, Cud, Cf, Gd^Fetd, Gd, Gd, Gd, Gd, Gd^Fetd, Gd, Gd, Gd, Gd, Gd, Gd, Gd, Gd, Gd, Gd, Gd, Gd
Re, Ss, Ww^Bsb|, Hh, Ww^Ewf, Cme, Re, Cme, Cme, Ww^Ewf, Ww^Ewf, Rr, Rr, Re, Ww^Ewl, Ww^Ewl, Ss, Qxu^Bcx|, Gll^Ftr, Gll^Ftr, Hh, Mm, Mm, Gd, Gd, Cf, Gd, Cf, Gll^Feth, Gll^Feth, Gd^Vhr, Gd, Gd, Gd^Fetd, Gd^Fetd, Gd, Gd, Gd, Gd, Gd, Gd, Gd, Gd^Vhr, Gd, Gd, Gd
Re, Ww^Ewf, Ww^Bsb|, Ww^Ewf, Gll^Ftr, Gll^Ftr, Re, Kh, Qxu^Bs\, Ww^Ewf, Ww^Ewf, Ww^Ewf, Rr, Gll^Ftr, Gll^Ftr, Ww^Ewl, Rr, Rr, Rr, Gll^Ftr, Hh, Md, Mm, Gd, Gd, Gd, Gd, Gd, Gll^Feth, Gd^Fetd, Gd, Gd, Cf, Gd, Gd^Fetd, Gd, Gd, Gd, Gd, Gd, Gd, Gd, Gd, Gd, Gd, Gd
Rr, Rr, Rr, Ww^Ewf, Gll^Ftr, Gll^Ftr, Gll^Ftr, Re, Gll^Ftr, Ww^Ewf, Ww^Ewl, Gll^Ftr, Rr, Hhd^Dr, Rr, Rr, Rr, Rr, Ww^Ewl, Ww^Ewl, Hh, Mm, Hhd, Mm, Gd, Gd, Gd, Gd, Gd, Gd^Fetd, Gd, Cf, 3 Cud, Cf, Gd, Gd^Fetd, Gd, Gd, Gd, Gd, Gd, Gll^Feth, Gll^Feth, Gd, Gd, Gd
Re, Ss^Vhs, Rr, Ww^Ewf, Re, Gll^Ftr, Gll^Ftr, Gll^Ftr, Ww^Ewl, Ww^Ewl, Gll^Ftr, Gll^Ftr, Gll^Ftr, Rr, Rr, Rr, Ww^PsgS, Ww^Ewl, Gll^Ftr, Gll^Ftr, Mm, Hhd, Hhd, Gd, Gd, Gd, Gd, Gd, Gd, Gd, Gd, Cf, Cf, Cf, Gd, Gd^Fetd, Gll^Feth, Gll^Feth, Gll^Feth, Gd^Fetd, Gd^Fetd, Gd^Fetd, Gll^Feth, Gll^Feth, Gd, Gd
Re, Rr, Qxu^Bh/, Chs, Re, Gll^Ftr, Ww^Ewl, Ww^Ewl, Ww^Ewl, Gll^Ftr, Gll^Ftr, Gll^Ftr, Gll^Ftr, Gll^Ftr, Ww^Ewl, Ww^Ewl, Gll^Ftr, Gg^Fet, Gll^Ftr, Gg^Fet, Hhd, Hhd, Hhd, Gd, Gd, Gd, Gd, Gd, Gll^Fdf, Gd^Fetd, Gd^Fetd, Gd, Gd, Gd, Gd, Gd, Gd^Fetd, Gll^Feth, Gd^Vhr, Gd^Fetd, Gd^Fetd, Gll^Feth, Gd^Fetd, Gd, Gd, Gd
Re, Re, Re, Re, Re, Ww^Ewl, Ww^Ewl, Ww^Ewl, Re, Re, Ww^Ewl, Kme, Cme, Kme, Ww^Vm, Ww^Ewl, Gll^Ftr, Gll^Ftr, Re, Gg^Fet, Mm, Mm, Gd, Gd, Gd^Vhr, Gd^Fetd, Gd, Gd, Gll^Feth, Gll^Feth, Gd^Fetd, Gd, Gd, Gd, Gd, Gd, Gd, Gll^Feth, Gll^Feth, Gll^Feth, Gll^Feth, Gd^Vhr, Gd^Fetd, Gd^Fetd, Gd, Gd
Re, Re, Re, Ss^Vhs, Rr^Bw\r, Ww^Ewl, Ww^Ewl, Re, Rr, Re, Ww^Ewl, Re, Re^Bsb/, Kh, Cme, Gll^Ftr, Re, Re, Re, Hh, Hh, Mm, Gd, Gd, Gd, Gd, Gd, Gll^Feth, Gll^Feth, Gd^Fetd, Gd^Fetd, Gd, Gd, Gd, Gd, Gd, Gd, Gd, Gd^Fetd, Gd^Fetd, Gd^Fetd, Gll^Feth, Gll^Feth, Gll^Feth, Gd, Gd
Re, Re, Ww^Ewf, Re, Ww^Ewf, Ww^Bw\r, Ww^Bw\r, Rr, Gs^Vht, Rr, Ww^Ewl, Re, Ww^Ewl, Ww^Ewl, Kme, Gll^Ftr, Re, Gll^Ftr, Re, Re, Hh, Mm, Gd, Gd, Cf, Cud, Cf, Gll^Feth, Gll^Feth, Gll^Feth, Gll^Feth, Gd, Gll^Feth, Gd, Gd, Gd, Gd, Gd, Gd^Fetd, Gd^Fetd, Gd^Fetd, Gll^Feth, Gll^Feth, Gll^Feth, Gd, Gd
Re, Re, Rr, Ww^Ewf, Ww^Ewf, Ww^Ewl, Ww^Ewf, Rr, Rr, Rr, Ww^Ewl, Ww^Ewl, Ww^Ewl, Kme, Ww^Ewl, Kme, Re, Re, Ww^Ewl, Ww^Ewl, Mm, Hh, Mm, Gd, Ias, Gd, Gd, Gd, Gll^Feth, Gll^Feth, Gd^Fetd, Gd^Fetd, Gd^Fetd, Gd, Gd, Gd, Gd, Gd, Gd, Gd^Fetd, Gd^Fetd, Gd^Fetd, Gll^Feth, Gll^Feth, Gd, Gd
Ww^Ewf, Ww^Ewf, Ww^Ewf, Ww^Ewf, Re, Ww^Ewf, Ww^Ewl, Ww^Ewl, Ww^Ewl, Ww^Bsb\, Rr, Ww^Ewl, Ww^Ewl, Ww^Ewl, Ww^Ewl, Ww^Ewl, Ww^Ewl, Ww^Ewl, Ww^Vm, Ww^Ewl, Mm, Kme, Md, Md, Gd, Gd^Vhr, Gd^Fetd, Gll^Feth, Gd^Fetd, Gd^Fetd, Gd^Fetd, Gll^Feth, Gll^Feth, Gd^Fetd, Gd^Fetd, Gd, Gd, Gd, Gd^Fetd, Gd^Fetd, Gd^Fetd, Gd, Gd, Rp, Sm, Gd
Ww^Ewf, Rr, Re, Kh, Ww^Ewf, Ww^Ewf, Ww^Ewf, Ww^Ewf, Ww^Ewf, Ww^Ewf, Rr, Rr, Rr, Ww^Ewl, Ww^Ewl, Ww^Ewl, Ww^Ewl, Ww^Vm, Ww^Ewl, Ww^Ewl, Ww^Ewl, Mm, Ur, Gd, Rb, Gd, Gd^Fetd, Gd^Fetd, Gd^Fetd, Gll^Feth, Gll^Feth, Gd, Gd^Fetd, Gd^Fetd, Gd, Gd^Fetd, Gd, Gd, Gd, Gd, Sm, Gd, Sm, Gd, Sm, Xu
Ww^Ewf, Ww^Ewf, Re, Qxu^Bs|, Ww^Ewf, Re, Re, Re, Ww^Ewf, Ww^Ewf, Rr, Cm, Ww^Ewl, Ww^Ewl, Ww^Ewl, Ss, Ww^Ewl, Ww^Ewl, Ww^Ewl, Ww^Ewl, Ww^Ewl, Ur, Sm, Sm, Rb, Sm, Rb, Sm, Sm, Gll^Feth, Gd^Fetd, Gd^Fetd, Sm, Sm, Sm, Gd, Sm, Sm, Sm, Sm, Sm, Sm, Sm, Sm, Sm, Xu
Ww^Ewf, Re, Re, Re, Ww^Ewf, Re, Re, Re, Re, Ww^Ewf, Ww^Ewf, Rr, Rr, Ww^Ewl, Ww^Ewl, Ww^Ewl, Ww^Ewl, Ww^Ewl, Ww^Ewl, Ww^Ewl, Hh, Ur, Sm, Rr^Vhc, Rb, Rb, Rb, Sm, Sm, Sm, Sm, Sm, Sm, Sm, Sm, Sm, Sm, Sm, Sm, Sm, Sm, Sm, Sm, Sm, Xu, Xu
Gg, Ww^Ewf, Gg^Esa, Re, Gg, Re, Gg, Re, Gg, Ww^Ewf, Gg, Ww^Ewf, Gg^Esa, Ww^Ewl, Gg^Esa, Ww^Ewl, Ww^Ewl, Ww^Ewl, Gg^Esa, Gg^Esa, Hh, Mm, Sm, Rp, Sm, Sm, Sm, Sm, Sm, Sm, Sm, Sm, Sm, Rb, Rb, Sm, Rr^Vhc, Rb, Sm, Sm, Sm, Sm, Sm, Sm, Sm, Xu
Gs, Gg^Esa, Gg, Gg^Esa, Gg^Esa, Gg^Esa, Gg^Esa, Gg^Esa, Gg^Esa, Gg^Esa, Gg^Esa, Gg^Esa, Ur^Esa, Gg^Esa, Ur, Gg^Esa, Gg^Esa, Gg^Esa, Gg^Esa, Gg^Esa, Hh, Md, Sm, Wwt^Bsb|, Sm, Sm, Sm, Sm, Sm, Sm, Sm, Sm, Sm, Rb, Sm, Rb, Rb, Rb, Sm, Sm, Sm, Sm, Sm, Sm, Xu, Xu
Gs, Gs, Gs, Ur, Gg, Gg, Ur, Ur, Ur, Wwt, Gg, Ur, Gll^Bw/r, Gg, Wwt, Wwt, Wwt, Gg^Esa, Ur, Gg, Hh, Md, Sm, Wwt^Bsb|, Wwf, Wwf, Wwg, Sm, Wwf, Sm, Sm, Sm, Sm, Sm, Rb, Rb, Sm, Sm, Sm, Sm, Sm, Sm, Wwrg, Wwrg, Xu, Xu
Gs, Gs, Gs, Gs, Gs, Ur, Gll, Ur, Gg, Wwt, Ww^Bw/r, Wwt^Bw/r, Wwt, Wwt, Gll, Wwt, Ur, Wwt, Ur, Gll, Hh, Mm, Sm, Ww^Bsb|, Ww, Ww, Wwf, Wwf, Wwf, Wwf, Sm, Sm, Sm, Sm, Sm, Wwt^Bsb\, Wwt^Bsb\, Sm, Sm, Sm, Sm, Sm, Wot, Wwrg, Wwrt, Xu
Gs, Gs, Gs, Kf, Gs, Gs, Gs, Gg, Gg, Ww^Bw/r, Ur, Wwt, Gs^Fms, Gs^Fms, Gs^Fms, Gs^Fds, Gg, Wwt, Wwt, Ur, Wwt, Mm, Sm, Rp, Rp, Wwg, Wwf, Wwf, Wwf, Sm, Sm, Sm, Sm, Sm, Wwf, Wwf, Wwf, Wwt^Bsb\, Wwt^Bsb\, Sm, Wwf, Wwf, Wwt, Wwrg, Xu, Xu
Gg, Gs, Gs, Gs, Ur, Ur, Ur, Gs, Irs, Wwt, Wwt, Gg, Gg, Gg, Gg, Gs^Fms, Gs^Fms, Ur, Ur, Wwt, Wwt, Mm, Sm, Rr^Vhc, Wwf, Wwf, Wwf, Wwf, Wwf, Wwf, Wwf, Sm, Wwf, Wwf, Ww, Ww, Wwt, Wwf, Wwf, Wwt^Bsb\, Wwt^Bsb\, Cme, Cme, Wwt, Wwr, Xu
Gg, Gs^Fms, Gs^Fms, Rrc^Edb, Gg^Gvs, Gs^Fms, Gs^Fms, Ur, Wwt, Wwt, Irs, Gg, Gg, Gg, Gg^Edp, Gg, Gg, Ur, Ur, Ur, Mm, Mm, Sm, Mm, Mm, Wwf, Rb, Wwf, Ww, Ww, Ww, Wwf, Ww, Ww, Wwg, Wwg, Kh, Wwf, Wwf, Wwf, Rb, Km, Rb, Wwf, Ww, Wwrt
Gg, Xof, Gs^Fms, Gs^Fms, Gs^Fms, Xof, Gs^Fms, Gs^Fms, Wwt, Ur, Ur, Gs, Gs, Gll, Gs, Gg, Gs, Gs, Cv, Mm, Hhd, Mm, Sm, Mm, Wwt, Uue, Rr^Vhc, Wwg, Ww, Wwg, Wwg, Wwf, Wwg, Wwg, Sm^Bsb/, Sm^Bsb/, Rb^Gvs, Sm^Bsb\, Sm^Bsb\, Rb, Wwt, Wwt, Sm^Bsb/, Rb, Wwrt, Wwrt
Gs^Fms, Gs^Fms, Gs^Fms, Ur, Gs^Fms, Gs^Fms, Gs^Fms, Wwt, Ur, Ur, Gll^Fdw, Ur, Ur, Gs, Gs, Gs, Rrc, Rrc, Ur, Hhd, Hhd, Mm, Wwf, Uhe, Mm, Mm, Mm, Rp, Ww, Wwg, Wwg, Wwg, Sm^Bsb/, Sm^Bsb/, Rb^Gvs, Rb^Gvs, Gs, Rb^Gvs, Rb^Gvs, Rb, Sm^Bsb/, Sm^Bsb/, Wwt, Wwt, Wwrg, Wwrt
Gs^Fms, Gs^Fms, Gs^Fms, Rrc^Esd, Ur, Gs^Fms, Ur, Ur, Ur, Gg^Ve, Rp^Gvs, Gg^Fet, Rd, Rrc^Edb, Rrc, Gs, Gs, Gs, Hhd, Hhd, Hhd, Md, Wwf, Wwt, Wwt, Wwt, Wwt, Wwt^Bsb|, Ww, Wwg, Wot, Rb, Rb^Gvs, Rr^Vhc, Rb^Gvs, Rb^Gvs, Gs, Gs, Sm^Bsb/, Sm^Bsb/, Ww, Wwt, Ww, Ww, Wwrt, Wwrt
Ur, Ur, Ur, Rrc, Rp, Rp^Gvs, Rp, Gg^Fet, Irs, Rp, Irs, Rp, Rp, Rrc^Edb, Gg^Ve, Gs, Gs, Gs, Hhd, Gs^Fms, Gs^Fms, Mm, Md, Wwt, Wwt, Ww, Ww, Ww^Bsb|, Wog, Wot, Rb, Gs, Rb^Gvs, Rb^Gvs, Rb^Gvs, Gs, Sm^Bsb/, Sm^Bsb/, Ww, Ww, Ww, Ww, Ww, Ww, Wwrt, Wwrt
Ur, Ur, Gs^Fms, Gg^Ve, Gs^Fms, Rp, Irs, Irs, Gs^Fds, Gg, Cv, Cv, Rp, Rp, Gs, Ur, Ur, Gg^Ve, Hh, Gs^Fms, Hh, Mm, Wwt, Wwt, Wwt, Wwt, Wwt, Wog^Bsb|, Rb, Rb, Rb^Gvs, Rb^Gvs, Ch, Ch, Cme, Sm^Bsb/, Ww, Ww, Ww, Ww, Wot, Ww, Ww, Ww, Wwrt, Wwrt
Gs, Gs^Fms, Gll^Fp, Gs^Fms, Gs, Gs, Irs, Gg^Ve, Irs, Rp, Irs, Kvr, Cv, Gs, Gs, Gs, Gg^Fet, Gs, Ur, Hh, Md, Mm, Md, Wwt, Cme, Cme, Ch, Wog^Bsb|, Rb, Wog, Rb, Rb^Gvs, Cme, 4 Km, Cme, Ww, Ww, Ww, Ww^Ii, Ww, Wot, Ww, Ww, Ww, Wwrt, Wwrt
Gll^Fp, Gs^Fms, Gs^Fms, Gll^Fp, Gs, Kv, Ur, Ur, Gs^Fms, Irs, Ur, Ur, Gs, Cv, Cv, Gs, Gs, Gs, Ur, Ur, Hh, Mm, Wwt, Gs, Gs, Kh, Rb, Rb, Wog, Wog^Bsb\, Rb, Sm^Bsb/, Ww, Cme, Ww, Ww^Bsb\, Ww^Bsb\, Ww^Ii, Ww, Ww, Ww, Ww, Ww, Ww, Wot, Wwrt
Gg, Gs^Fms, Gg^Gvs, Gg, Ur, Gs^Fms, Ur, Ur, Gll^Fp, Gs^Fms, Ur, Gg, Gs, Gs, Gs, Cv, Gs, Gs, Ur, Ur, Mm, Mm, Wwt, Wwt, Gs, Gs, Ww, Wog, Wog^Ii, Wog, Wog, Ww, Wot, Wot^Ii, Wot, Ww^Ii, Ww, Ww^Bsb\, Rb, Rb, Uhe, Ww, Ww, Wot, Wwrt, Wwrt
Gg, Gg^Gvs, Gg^Gvs, Gg^Gvs, Gg^Fet, Gg^Fet, Gs^Fds, Gs^Fms, Gll^Fp, Gll^Fp, Gll^Fp, Ur, Gs^Gvs, Gs, Gs^Gvs, Kf, Gs, Gs, Gs, Ur, Md, Mm, Mm, Rr^Vhc, Wwt, Ww, Ww, Ww, Ww, Wog^Ii, Wog, Ww^Ii, Wot, Wot^Ii, Ww, Ww^Ii, Ww, Ww, Rb^Gvs, Rr^Vhc, Ww, Ww, Ww, Wot, Wwrg, Wwrt
Gg^Gvs, Gg^Gvs, Gg^Gvs, Gg^Gvs, Gg^Fet, Gg^Fet, Gs^Fds, Gs^Fds, Gg^Fet, Gll^Fp, Gg^Gvs, Gg^Gvs, Ur, Gs^Gvs, Gs, Gs, Gg^Fet, Gs, Gg^Ve, Ur, Hh, Mm, Wwt, Wwt, Ww, Ww, Wwt, Ww, Ww, Wog, Ww, Ww, Ww, Ww, Ww^Ii, Ww, Ww, Ww, Ww, Rb^Gvs, Ww, Wot, Ww, Wwrg, Wwrt, Wwrt
Gg^Gvs, Gg^Gvs, Gg^Gvs, Gg^Fet, Gg^Gvs, Gg^Fet, Gg^Fet, Gg^Fet, Gg^Gvs, Gg^Gvs, Gg^Gvs, Gg^Ve, Rp, Gs^Fms, Gs^Fms, Gs, Gg^Fet, Gs, Ur, Ur, Md, Mm, Wwt, Wwt, Ww, Ww, Ww, Ww, Ww, Ww, Ww, Ww, Ww, Ww, Ww, Ww, Wwr, Ww, Ww, Wwr, Ww, Wot, Ww, Wwrt, Wwrt, Wwrt
Gg, Gg^Gvs, Gg^Gvs, Gg^Gvs, Gg^Gvs, Gg^Gvs, Gg, Gg^Gvs, Gg^Gvs, Gg^Gvs, Gg, Gg, Gg, Ur, Gg, Rp, Gg, Gg, Gg, Ur, Gg, Mm, Gg, Wwr, Gg, Ww, Gg, Ww, Gg, Ww, Sm, Ww, Ww, Ww, Ww, Ww, Ww, Ww, Ww, Ww, Ww, Ww, Gg, Wwrt, Sm, Wwrt
