Hh^Esa, Hh^Esa, Hh^Esa, Hh^Esa, Hh^Esa, Wwt, Wwt, Re^Esa, Re^Esa, Re^Esa, Re^Esa, Re, Re^Esa, Re, Hh, Hh, Hh, Hh, Hh, Hh, Hh, Gg, Mm, Ias, Gd, Gd, Gd, Gd, Gd, Gd, Gd, Gd, Gd, Gd, Gd, Gd, Gd, Gd, Gd, Gd, Gd, Gd, Gd, Gd, Gd, Gd
Hh^Esa, Hh^Esa, Hh^Vhh, Rr^Esa, Hh^Esa, Wwt, Re^Esa, Wwt, Re^Esa, Wwt, Rb, Re^Esa, Rr^Esa, Rr^Esa, Wwt^Esa, Wwt^Esa, Wwt, Hh, Hh, Hh, Mm, Mm, Hhd, Gd, Gd, Gd, Ias, Gd, Gd^Fetd, Gd, Gd, Gd, Gll^Fdw, Gd, Gd, Gd, Gd, Gd, Gd, Gd, Gd, Gd, Gd, Gd, Gd, Gd
Hh^Esa, Hh^Esa, Rp, Rr^Esa, Hh, Hh^Esa, Cme, Wwt, Re^Esa, Re^Esa, Re^Esa, Rr^Esa, Rb, Re^Esa, Re^Esa, Wwt^Esa, Wwt, Kv, Hh, Hh, Hh, Mm, Mm, Gd, Gd, Cf, Cud, Cf, Gd^Fetd, Gd, Gd, Gd, Gd, Gll^Fdw, Gd, Gd, Gd, Gd, Gd, Gd, Gd, Gd, Gd, Gd, Gd, Gd
Re^Esa, Wwt, Ww^Bsb|, Hh^Esa, Ww^Ewf, Cme, Re, Cme, Cme, Wwt, Wwt, Rr, Rr^Esa, Re^Esa, Wwt, Wwt, Ww^Ewl, Qxu^Bcx|, Gll^Fp, Gll^Fp, Hh, Mm, Mm, Gd, Gd, Cf, Gd, Cf, Gll^Feth, Gll^Feth, Gd, Gd, Gd, Gll^Fdw, Gd^Fetd, Gd, Gd, Gd, Gd, Gd, Gd, Gd, Gd, Gd, Gd, Gd
Re^Esa, Ww^Ewf, Ww^Bsb|, Ww^Ewf, Gll^Fp, Gll^Fp, Re, Kh, Qxu^Bs\, Wwt, Wwt, Wwt, Rr^Esa, Gll^Fp, Gll^Fp, Wwt, Rr^Esa, Rr^Esa, Rr^Esa, Gll^Fp, Hh, Md, Mm, Gd, Gd, Gd, Gd, Gd, Gll^Feth, Gd^Fetd, Gd, Gd, Cf, Gd, Gd^Fetd, Gd, Gd, Gd, Gd, Gd, Gd, Gd, Gd, Gd, Gd, Gd
Rr^Esa, Rr^Esa, Rr^Esa, Ww^Ewf, Gll^Fp, Gll^Fp, Gll^Fp, Re, Gll^Fp, Wwt, Wwt, Gll^Fp, Rr^Esa, Hhd^Dr, Rr^Esa, Rr^Esa, Rr^Esa, Rr^Esa, Wwt^Esa, Wwt^Esa, Hh, Mm, Hhd, Mm, Gd, Gd, Gd, Gd, Gd, Gd^Fetd, Gd, Cf, 3 Cud, Cf, Gd, Gd^Fetd, Gd, Gd, Gd, Gd, Gd, Gll^Feth, Gll^Fdw, Gd, Gd, Gd
Re^Esa, Hhd^Vhhr, Rr^Esa, Ww^Ewf, Re^Esa, Gll^Fp, Gll^Fp, Gll^Fp, Wwt, Wwt, Gll^Fp, Gll^Fp, Gll^Fp, Rr^Esa, Rr^Esa, Rr^Esa, Wwt^Esa, Wwt, Gll^Fp, Gll^Fp, Mm, Hhd, Hhd, Gd, Rd, Gd, Rd, Gd, Rd, Gd, Rd, Cf, Cf, Cf, Rd, Gd^Fetd, Gll^Feth, Gll^Feth, Gll^Feth, Gd^Fetd, Gd^Fetd, Gd^Fetd, Gll^Fdw, Gll^Feth, Rd, Gd
Re^Esa, Rr^Esa, Qxu^Bh/, Chr, Re^Esa, Gll^Fp, Wwt^Esa, Wwt^Esa, Wwt^Esa, Gll^Fp, Gll^Fp, Gll^Fp, Gll^Fp, Gll^Fp, Wwt, Wwt^Esa, Gll^Fp, Gg^Fet, Gll^Fp, Gg^Fet, Hhd, Hhd, Hhd, Rd, Rd, Rd, Rd, Rd, Gll^Fdw, Gd^Fetd, Gd^Fetd, Rd, Rd, Rd, Rd, Rd, Gd^Fetd, Gll^Feth, Gd^Vhr, Gd^Fetd, Gd^Fetd, Gll^Feth, Gd^Fetd, Rd, Rd, Rd
Re^Esa, Re, Re^Esa, Re^Esa, Re^Esa, Wwt, Wwt^Esa, Wwt^Esa, Re^Esa, Re^Esa, Wwt, Kme, Cme, Kme, Ww^Vm, Wwt, Gll^Fp, Gll^Fp, Re^Esa, Gg^Fet, Mm, Mm, Rd, Rd, Gd^Vhr, Gd^Fetd, Rd, Rd, Gll^Feth, Gll^Feth, Gd^Fetd, Rd, Rd, Rd, Rd, Rd, Rd, Gll^Fdw, Gll^Fdw, Gll^Feth, Gll^Feth, Gd^Vhr, Gd^Fetd, Gd^Fetd, Rd, Rd
Re^Esa, Re^Esa, Re^Esa, Hhd^Vhhr, Rr^Bw\r, Wwt, Wwt, Re^Esa, Rr, Re^Esa, Wwt, Re, Mm, 2 Kh, Cme, Gll^Fp, Re^Esa, Re, Re^Esa, Hh, Hh, Mm, Rd, Rd, Rd, Rd, Rd, Gll^Feth, Gll^Feth, Gd^Fetd, Gd^Fetd, Rd, Rd, Rd, Rd, Rd, Rd, Rd, Gll^Fdw, Gll^Fdw, Gll^Fdw, Gll^Feth, Gll^Feth, Gll^Feth, Rd, Rd
Re^Esa, Re^Esa, Wwt, Re^Esa, Wwt, Ww^Bw\r, Ww^Bw\r, Rr^Esa, Hhd^Vhhr, Rr^Esa, Wwt, Re, Wwt, Wwt, Kme, Gll^Fp, Re, Gll^Fp, Re^Esa, Re^Esa, Hh, Mm, Rd, Rd, Cf, Cud, Cf, Gll^Feth, Gll^Feth, Gll^Feth, Gll^Feth, Rd, Gll^Fdw, Rd, Rd, Rd, Rd, Rd, Gll^Fdw, Gll^Fdw, Gll^Fdw, Gll^Fdw, Gll^Feth, Gll^Feth, Rd, Rd
Re^Esa, Re^Esa, Rr^Esa, Wwt, Wwt, Wwt^Esa, Wwt, Rr^Esa, Rr^Esa, Rr^Esa, Wwt, Wwt^Esa, Wwt, Kme, Wwt, Kme, Re^Esa, Re^Esa, Wwt, Ww^Ewl, Mm, Hh, Mm, Rd, Ias, Rd, Gd, Rd, Gll^Feth, Gll^Feth, Gd^Fetd, Gll^Fdw, Gll^Fdw, Rd, Rd, Rd, Rd, Rd, Gd, Gll^Fdw, Gll^Fdw, Gll^Fdw, Gll^Fdw, Gll^Fdw, Rd, Rd
Wwt, Wwt, Wwt, Wwt, Re^Esa, Wwt, Wwt^Esa, Wwt, Wwt, Ww^Bsb\, Rr^Esa, Wwt, Wwt, Wwt, Wwt^Esa, Wwt, Wwt, Wwt, Ww^Vm, Wwt, Mm, Kme, Md, Md, Rd, Gd^Vhr, Gll^Fdw, Gll^Fdw, Gd^Fetd, Gd^Fetd, Gll^Fdw, Gll^Fdw, Gll^Fdw, Gll^Fdw, Gll^Fdw, Rd, Rd, Rd, Gll^Fdw, Gll^Fdw, Gll^Fdw, Rd, Rd, Rd, Rd, Rd
Wwt, Rr^Esa, Re^Esa, Kh, Wwt, Wwt, Wwt, Wwt, Wwt^Esa, Wwt^Esa, Rr^Esa, Rr^Esa, Rr^Esa, Wwt, Wwt, Wwt, Wwt, Ww^Vm, Wwt, Wwt, Wwt, Mm, Ur, Rd, Rb, Rd, Gll^Fdw, Gll^Fdw, Gll^Fdw, Gll^Fdw, Gll^Fdw, Gd, Gll^Fdw, Gll^Fdw, Rd, Gll^Fdw, Rd, Rd, Rd, Rd, Rd, Rd, Rd, Rd, Rd, Xu
Wwt, Wwt, Re^Esa, Qxu^Bs|, Wwt, Re^Esa, Re^Esa, Re^Esa, Wwt, Wwt, Rr^Esa, Cm, Wwt, Wwt, Wwt^Esa, Ww^Ewl, Wwt, Wwt, Wwt, Wwt^Esa, Wwt, Ur, Sm, Rd, Rb, Rd, Rb, Rd, Rd, Gll^Fdw, Gll^Fdw, Gll^Fdw, Rd, Rd, Rd, Rd, Rd, Rd, Sm, Rd, Rd, Rd, Rd, Rd, Sm, Xu
Wwt, Re^Esa, Re^Esa, Re^Esa, Wwt, Re^Esa, Re^Esa, Re^Esa, Re^Esa, Wwt, Wwt, Rr^Esa, Rr^Esa, Wwt, Wwt, Wwt, Wwt, Wwt^Esa, Wwt, Wwt, Hh, Ur, Sm, Rr^Vhc, Rb, Rb, Rb, Sm, Sm, Rd, Sm, Sm, Sm, Rd, Sm, Sm, Sm, Sm, Sm, Sm, Sm, Sm, Sm, Sm, Xu, Xu
Gg, Wwt, Gg^Esa, Re^Esa, Gg, Re, Gg, Re^Esa, Gg, Wwt, Gg, Wwt, Gg^Esa, Wwt, Gg^Esa, Wwt, Wwt, Wwt, Gg^Esa, Gg^Esa, Hh, Mm, Sm, Rp, Sm, Sm, Sm, Sm, Sm, Sm, Sm, Sm, Sm, Rb, Rb, Sm, Rb, Rb, Sm, Sm, Sm, Sm, Sm, Sm, Sm, Xu
Gs, Gg^Esa, Gg, Gg^Esa, Gg^Esa, Gg^Esa, Gg^Esa, Gg^Esa, Gg^Esa, Gg^Esa, Gg^Esa, Gg^Esa, Ur^Esa, Gg^Esa, Ur, Gg^Esa, Gg^Esa, Gg^Esa, Gg^Esa, Gg^Esa, Hh, Md, Sm, Sm, Sm, Sm, Sm, Sm, Sm, Sm, Sm, Sm, Sm, Rb, Sm, Rb, Rb, Rb, Sm, Sm, Sm, Sm, Sm, Sm, Xu, Xu
Gs, Gs, Gs, Ur, Gg, Gg, Ur, Ur, Ur, Wwt, Gg, Ur, Gg^Bw/, Gg, Wwt, Wwt, Wwt, Gg^Esa, Ur, Gg, Hh, Md, Sm, Sm^Bsb|, Sm, Sm, Sm, Sm, Sm, Sm, Sm, Sm, Sm, Sm, Rb, Rb, Sm, Sm, Sm, Sm, Sm, Sm, Sm, Sm, Xu, Xu
Gs, Gs, Gs, Gs, Gs, Ur, Gll, Ur, Gg, Wwt, Ww^Bw/r, Wwt^Bw/r, Wwt, Wwt, Gll^Fp, Wwt, Ur, Wwt, Ur, Gll, Hh, Mm, Sm, Sm^Bsb|, Sm, Sm, Sm, Sm, Sm, Sm, Sm, Sm, Sm, Sm, Sm, Sm^Bsb\, Sm^Bsb\, Sm, Sm, Sm, Sm, Sm, Sm, Sm, Sm, Xu
Gll^Fp, Gs, Gs, Kf, Gs, Gs, Gs, Gg, Gg, Ww^Bw/r, Ur, Wwt, Gs^Fms, Gs^Fms, Gs^Fms, Gs^Fds, Gll^Fp, Wwt, Wwt, Ur, Wwt, Mm, Sm, Rp, Rp, Sm, Sm, Sm, Sm, Sm, Sm, Sm, Sm, Sm, Sm, Sm, Sm, Sm^Bsb\, Sm^Bsb\, Sm, Sm, Sm, Sm, Sm, Xu, Xu
Gll^Fp, Gll^Fp, Gs^Fms, Gs, Ur, Ur, Ur, Gs^Fms, Gg^Fet, Wwt, Wwt, Gs^Fds, Gs^Fds, Gs^Fds, Gs^Fds, Gs^Fms, Gs^Fms, Ur, Ur, Wwt, Wwt, Mm, Sm, Rr^Vhc, Sm, Sm, Sm, Sm, Sm, Sm, Sm, Sm, Sm, Sm, Sm, Sm, Sm, Sm, Sm, Sm^Bsb\, Sm^Bsb\, Cme, Cme, Sm, Sm, Xu
Gs^Fms, Gs^Fms, Gs^Fms, Rrc^Edb, Gg^Gvs, Gs^Fms, Gs^Fms, Ur, Wwt, Wwt, Gg^Fet, Gll^Fp, Gs^Fds, Gs^Fds, Gs^Fms, Gs^Fms, Gll^Fp, Gs^Fds, Gs^Fds, Ur, Mm, Mm, Sm, Mm, Mm, Sm, Rb, Sm, Sm, Sm, Sm, Sm, Sm, Sm, Sm, Sm, Kh, Sm, Sm, Sm, Rb, Km, Rb, Sm, Sm, Sm
Gs^Fms, Xof, Gs^Fms, Gs^Fms, Gs^Fms, Xof, Gs^Fms, Gs^Fms, Wwt, Ur, Ur, Gs, Gs, Gll, Gs, Gs^Fds, Gs, Gll^Fp, Cv, Mm, Hh, Mm, Sm, Mm, Sm, Uue, Rr^Vhc, Sm, Sm, Sm, Sm, Sm, Sm, Sm, Sm^Bsb/, Sm^Bsb/, Rb, Sm^Bsb\, Sm^Bsb\, Rb, Sm, Sm, Sm^Bsb/, Rb, Sm, Sm
Gs^Fms, Gs^Fms, Gs^Fms, Ur, Gs^Fms, Gs^Fms, Gs^Fms, Wwt, Ur, Ur, Gg^Fet, Ur, Ur, Gs, Gs, Gs^Fds, Rrc, Rrc, Ur, Hh, Hh, Mm, Sm, Uhe, Mm, Mm, Mm, Rp, Sm, Sm, Sm, Sm, Sm^Bsb/, Sm^Bsb/, Rb, Rb, Re, Rb, Rb, Rb, Sm^Bsb/, Sm^Bsb/, Sm, Sm, Sm, Sm
Gs^Fms, Gs^Fms, Gs^Fms, Rrc^Esd, Ur, Gs^Fms, Ur, Ur, Ur, Gg^Ve, Rp^Gvs, Gg^Fet, Rd, Rrc^Edb, Rrc, Gs, Gs, Gs, Hh, Hh, Hh, Md, Sm, Sm, Sm, Sm, Sm, Sm^Bsb|, Sm, Sm, Sm, Rb, Rb, Rr^Vhc, Rb, Re, Re, Re, Sm^Bsb/, Sm^Bsb/, Sm, Sm, Sm, Sm, Sm, Sm
Gs^Fds, Gs^Fds, Ur, Rrc, Gs^Fds, Gs^Fds, Rp, Gg^Fet, Gs^Fms, Rp, Irs, Rp, Rp, Rrc^Edb, Gg, Gs, Gs, Gs, Hh, Gs^Fms, Gs^Fms, Mm, Md, Sm, Sm, Sm, Sm, Sm^Bsb|, Sm, Sm, Rb, Rb, Rb, Rb, Rb, Re, Sm^Bsb/, Sm^Bsb/, Sm, Sm, Sm, Sm, Sm, Sm, Sm, Sm
Gs^Fds, Gs^Fds, Gs^Fms, Gg^Ve, Gs^Fms, Gs^Fds, Gs^Fds, Gg^Fet, Gs^Fds, Gg, Cv, Cv, Rp, Rp, Gs, Ur, Ur, Gg, Hh, Gs^Fms, Hh, Mm, Sm, Sm, Sm, Sm, Sm, Sm^Bsb|, Rb, Rb, Rb, Rb, Ch, Ch, Cme, Sm^Bsb/, Sm, Sm, Sm, Sm, Sm, Sm, Sm, Sm, Sm, Sm
Gs^Fds, Gs^Fms, Gll^Fp, Gs^Fms, Gg^Fet, Gs, Gs^Fms, Gg^Ve, Gs^Fms, Rp, Irs, Kvr, Cv, Gs, Gs, Gs, Gg^Fet, Gs, Ur, Hh, Md, Mm, Md, Sm, Cme, Cme, Ch, Sm^Bsb|, Rb, Sm, Rb, Rb, Cme, Km, Cme, Sm, Sm, Sm, Sm, Sm, Sm, Sm, Sm, Sm, Sm, Sm
Gs^Fds, Gs^Fms, Gs^Fms, Gll^Fp, Gg^Fet, Kv, Ur, Ur, Gs^Fms, Irs, Ur, Ur, Gs, Cv, Cv, Gs, Gs, Gs, Ur, Ur, Hh, Mm, Sm, Re, Re, Kh, Rb, Rb, Sm, Sm^Bsb\, Rb, Sm^Bsb/, Sm, Cme, Sm, Sm^Bsb\, Sm^Bsb\, Sm, Sm, Sm, Sm, Sm, Sm, Sm, Sm, Sm
Gg, Gs^Fms, Gg^Gvs, Gg, Gg^Fet, Gs^Fms, Ur, Ur, Gll^Fp, Gs^Fms, Ur, Gg, Gs, Gs, Gs, Cv, Gs, Gs, Ur, Ur, Mm, Mm, Sm, Sm, Re, Re, Sm, Sm, Sm, Sm, Sm, Sm, Sm, Sm, Sm, Sm, Sm, Sm^Bsb\, Rb, Rb, Uhe, Sm, Sm, Sm, Sm, Sm
Gg, Gg^Gvs, Gg^Gvs, Gg^Gvs, Gg^Fet, Gg^Fet, Gs^Fds, Gs^Fms, Gll^Fp, Gll^Fp, Gll^Fp, Ur, Gs^Gvs, Gs, Gs^Gvs, Kf, Gs, Gs, Gll^Fp, Ur, Md, Mm, Mm, Uhe, Sm, Sm, Sm, Sm, Sm, Sm, Sm, Sm, Sm, Sm, Sm, Sm, Sm, Sm, Rd, Uhe, Sm, Sm, Sm, Sm, Sm, Sm
Gg^Gvs, Gg^Gvs, Gg^Gvs, Gg^Gvs, Gg^Fet, Gg^Fet, Gs^Fds, Gs^Fds, Gg^Fet, Gll^Fp, Gg^Gvs, Gg^Gvs, Ur, Gs^Gvs, Gs^Fds, Gs, Gg^Fet, Gll^Fp, Gg^Ve, Ur, Hh, Mm, Sm, Sm, Sm, Sm, Sm, Sm, Sm, Sm, Sm, Sm, Sm, Sm, Sm, Sm, Sm, Sm, Sm, Rd, Sm, Sm, Sm, Sm, Sm, Sm
Gg^Gvs, Gg^Gvs, Gg^Gvs, Gg^Fet, Gg^Gvs, Gg^Fet, Gg^Fet, Gg^Fet, Gg^Gvs, Gg^Gvs, Gg^Gvs, Gg^Ve, Rp, Gs^Fms, Gs^Fms, Gll^Fp, Gg^Fet, Gll^Fp, Ur, Ur, Md, Mm, Sm, Sm, Sm, Sm, Sm, Sm, Sm, Sm, Sm, Sm, Sm, Sm, Sm, Sm, Sm, Sm, Sm, Sm, Sm, Sm, Sm, Sm, Sm, Sm
Gg, Gg^Gvs, Gg^Gvs, Gg^Gvs, Gg^Gvs, Gg^Gvs, Gg, Gg^Gvs, Gg^Gvs, Gg^Gvs, Gg, Gg, Gg, Gs^Fds, Gg, Rp, Gg, Gg, Gg, Ur, Gg, Mm, Sm, Sm, Sm, Sm, Sm, Sm, Gg, Sm, Sm, Sm, Sm, Sm, Sm, Sm, Ww, Sm, Ww, Sm, Ww, Sm, Gg, Sm, Sm, Sm
