Ha, Ha, Ha, Ha, Ha, Ai, Ai^Esa, Aa, Aa^Esa, Aa, Aa^Esa, Aa^Esa, Aa, Re, Ha, Ha, Ha, Ha, Ha, Ha, Ha, Gg, Ms^Xm, Ds, Ds, Rd, Rd, Rd, Rd, Rd, Dd, Rd, Rd, Rd, Rd, Rd, Rd, Rd, Rd, Rd, Ds, Ds, Ds, Ds, Ds, Gd
Ha, Ha, Ha^Vhha, Rra, Ha, Ai, Aa, Ai^Esa, Aa, Ai, Aa^Esa, Aa^Esa, Rra^Esa, Rra, Ai^Esa, Ai^Esa, Ai, Ha, Ha, Ha, Ms^Xm, Ms^Xm, Hhd, Ds, Ds, Rd, Ias, Rd, Rd, Dd, Dd, Rd, Gll^Fdw, Dd, Dd, Rd, Rd, Rd, Ds, Ds, Ds, Ds, Ds, Ds, Ds, Ds
Ha, Ha, Rra, Rra, Ha, Ha, Coa, Ai^Esa, Aa^Esa, Aa^Esa, Aa^Esa, Rra^Esa, Aa, Aa, Aa, Ai^Esa, Ai, Kva, Ha, Ha, Ha, Ms^Xm, Ms^Xm, Ds, Ds, Cd, Cud, Cd, Rd, Rd, Dd, Rd, Rd, Gll^Fdw, Dd, Dd, Dd, Rd, Rd, Ds, Ds, Ds, Rd, Ds, Ds, Ds
Aa^Esa, Ai, Ww^Bsb|, Ha, Ai, Coa, Aa^Fda, Coa, Coa, Ai^Esa, Ai^Esa, Rra, Rra^Esa, Aa, Ai, Ai^Esa, Ai, Qxu^Bcx|, Aa^Fda, Aa^Fda, Ha, Ms^Xm, Ms^Xm, Ds, Ds, Cer, Gd, Cte, Rd, Dd, Dd, Dd, Rd, Gll^Fdw, Gd^Fetd, Dd, Dd, Rd, Rd, Rd, Rd, Rd, Ds, Rd, Ds, Ds
Aa^Esa, Ai, Ww^Bsb|, Ai, Aa^Fpa, Aa^Fpa, Aa^Feta, Kha, Qxu^Bs\, Ai, Ai^Esa, Ai^Esa, Rra, Aa^Fda, Aa^Fda, Ai^Esa, Rra^Esa, Rra^Esa, Ha, Aa^Fda, Ha, Ms^Xm, Ms^Xm, Ds, Ds, Ds, Ds, Gd, Dd, Dd, Dd, Rd, Cte, Gd, Gd^Fetd, Rd, Dd, Dd, Ds, Ds, Ds, Rd, Gd, Ds, Ds, Ds
Rra, Rra, Rra, Ai, Aa^Fpa, Aa^Fpa, Aa^Fpa, Aa^Feta, Aa^Fpa, Ai^Esa, Ai^Esa, Aa^Fpa, Aa^Fpa, Ha, Rra^Esa, Rra, Rra^Esa, Rra, Ai^Esa, Ai, Ha, Ms, Hhd, Mm, Ds, Ds, Ds, Ds, Ds, Dd, Rd, Cd, Cud, Cd, Ds, Gd^Fetd, Ds, Dd, Gd, Ds, Gd, Ds, Gll^Fdw, Ds, Ds, Ds
Aa^Esa, Ha^Vhha, Rra, Ai, Aa, Aa^Fpa, Aa^Fpa, Aa^Fpa, Ai^Esa, Ai^Esa, Aa^Fpa, Aa^Fpa, Aa^Fpa, Rra, Rra, Rra, Ai^Esa, Ai^Esa, Aa^Fpa, Aa^Fpa, Ms^Xm, Ha, Hhd, Ds, Rd, Ds, Rd, Dd, Ds, Rd, Rd, Cte, Cd, Cd, Rd, Gd^Fetd, Gll^Feth, Gll^Feth, Gll^Feth, Gd^Fetd, Gd^Fetd, Ds, Gll^Fdw, Ds, Ds, Ds
Aa^Esa, Rra, Qxu^Bh/, Chr, Aa^Fpa, Aa^Fpa, Ai^Esa, Ai^Esa, Ai^Esa, Aa^Fpa, Aa^Fpa, Aa^Fpa, Aa^Fpa, Aa^Fpa, Ai, Ai^Esa, Aa^Fpa, Aa^Feta, Aa^Feta, Aa^Feta, Ha, Ha, Hhd, Rd, Rd, Rd, Rd, Rd, Dd^Ftd, Dd, Dd, Rd, Dd, Rd, Dd, Rd, Gd^Fetd, Gll^Feth, Dd^Vdt, Gd^Fetd, Gd^Fetd, Ds, Ds, Rd, Rd, Ds
Aa^Esa, Aa, Aa^Fpa, Aa, Aa^Esa, Ai, Ai^Esa, Ai^Esa, Aa^Esa, Aa^Esa, Ai, Cfa, Cme, Cfa, Ww^Vm, Ai, Aa^Fpa, Aa^Fpa, Aa^Feta, Aa^Feta, Ms, Ms, Rd, Rd, Dd^Vda, Gd^Fetd, Rd, Ds, Dd^Ftd, Dd, Dd, Dd, Dd, Dd, Dd, Dd, Dd, Gll^Fdw, Gll^Fdw, Gll^Feth, Ds, Dd^Vdr, Ds, Ds, Rd, Rd
Aa^Esa, Aa^Esa, Aa, Ha^Vhha, Rr^Bw\r, Ai, Ai, Aa^Esa, Rra^Esa, Aa^Esa, Ai, Aa, Ms, Kha, Cfa, Aa^Fpa, Ha, Aa^Feta, Aa^Feta, Ha, Ha, Ms, Rd, Rd, Rd, Rd, Rd, Ds, Dd^Ftd, Dd^Ftd, Dd^Ftd, Dd, Dd, Dd, Dd, Dd, Dd, Dd, Gll^Fdw, Ds, Dd, Ds, Ds, Ds, Rd, Rd
Aa^Esa, Aa^Esa, Ai, Aa, Ai, Ai^Bw\r, Ai^Bw\r, Rra^Esa, Ha^Vhha, Rra^Esa, Ai, Aa^Esa, Ai, Ai, Cfa, Aa^Fpa, Ha, Aa^Fpa, Aa^Esa, Aa^Esa, Hh, Ms, Rd, Rd, Cte, Cud, Cte, Ds, Dd^Ftd, Dd^Ftd, Ds, Dd, Gd^Fts, Dd, Dd, Dd, Dd, Dd, Dd, Dd, Dd, Dd, Dd, Ds, Rd, Rd
Aa, Aa^Esa, Rra, Ai, Ai, Ai^Esa, Ai, Rra^Esa, Rra^Esa, Rra^Esa, Ai, Ai^Esa, Ai, Cfa, Ai, Cfa, Aa^Esa, Aa^Esa, Ai, Ai, Ms, Hh, Mm, Rd, Ias, Rd, Ds, Rd, Ds, Ds, Ds, Dd, Gd^Fts, Dd, Dd, Dd, Dd, Dd, Dd, Rd, Rd, Dd, Dd, Rd, Rd, Rd
Ai, Ai, Ai^Esa, Ai, Aa^Esa, Ai, Ai^Esa, Ai, Ai^Esa, Ww^Bsb\, Rra, Ai, Ai, Ai, Ai, Ai, Ai^Esa, Ai, Ww^Vm, Ai, Mm, Kme, Md, Md, Ds, Dd^Vda, Gll^Edpp, Gll^Edpp, Ds, Ds, Dd, Dd, Dd, Gll^Fdw, Dd^Dc, Dd, Dd, Dd, Rd, Rd, Rd, Rd, Rd, Rd, Rd, Rd
Ai, Rra, Aa, Kh, Ai, Ai, Ai^Esa, Ai, Ai^Esa, Ai, Rra, Rra, Rra, Ai, Ai^Esa, Ai^Esa, Ai^Esa, Ww^Vm, Ai, Ai, Ai, Mm, Ur, Ds, Rb, Ds, Gll^Edpp, Gll^Edpp, Dd, Dd, Ds, Dd, Dd, Dd, Rd, Dd^Dc, Dd, Rd, Rd, Rd, Rd, Rd, Rd, Rd, Rd, Xu
Ai^Esa, Ai^Esa, Aa^Esa, Qxu^Bs|, Ai, Aa^Esa, Aa^Esa, Aa, Ai, Ai^Esa, Rra, Cm, Ai, Ai, Ai^Esa, Ai^Esa, Ai^Esa, Ai, Ai^Esa, Ai^Esa, Ai, Ur, Qlf, Rd, Rb, Ds, Rb, Rd, Rd, Dd^Dc, Ds, Ds, Rd, Rd, Dd, Dd, Dd, Rd, Uu, Rd, Rd, Rd, Rd, Rd, Uh, Xu
Ai, Aa^Esa, Aa^Esa, Aa, Ai, Aa^Esa, Aa^Esa, Aa^Esa, Aa, Ai^Esa, Ai, Rra, Rra, Ai^Esa, Ai, Ai^Esa, Ai^Esa, Ai^Esa, Ai^Esa, Ai, Hh, Ur, Qlf, Uu^Vud, Urc, Rb, Rb, Sm, Uu, Rd, Uu, Uu, Uu, Rd, Uu, Uu, Uu, Uu, Uh, Uu, Uu, Uu, Uh, Uh, Xu, Xu
Gg, Ai^Esa, Gg^Esa, Aa^Esa, Gg, Aa, Gg, Aa, Gg, Ai, Gg, Ai, Gg^Esa, Ai, Gg^Esa, Ai, Ai, Ai^Esa, Gg^Esa, Gg^Esa, Hh, Mm, Qlf, Rp, Sm, Urc, Urc, Uh, Uh, Uh, Uh, Uu, Uh, Uu, Uu, Uu, Uh, Uh, Uh, Uh, Uh, Uh, Uh, Uh, Uh, Xu
Gs, Gg^Esa, Gg, Gg^Esa, Gg^Esa, Gg^Esa, Gg^Esa, Gg^Esa, Gg^Esa, Gg^Esa, Gg^Esa, Gg^Esa, Ur^Esa, Gg^Esa, Ur, Gg^Esa, Gg^Esa, Gg^Esa, Gg^Esa, Gg^Esa, Hh, Md, Qlf, Qlf, Qlf, Qlf, Qlf, Urc, Urc, Uu, Uu, Uh, Uu, Uh, Uh, Uh, Uu, Uh, Qlf, Qlf, Qlf, Uh, Uh, Uh, Xu, Xu
Gg^Fet, Gg^Fet, Gg^Fet, Gg^Fet, Gg^Fet, Gg^Fet, Gg^Fet, Ur^Gvs, Ur^Gvs, Wwt, Gg^Gvs, Ur, Gg^Bw/, Gg, Wwt, Wwt, Wwt, Gg^Esa, Ur, Gs^Fms, Hh, Md, Qlf, Sm^Bsb|, Qlf, Qlf, Qlf, Uu, Sm, Urc, Urc, Uu, Uu, Uu, Urc, Rb, Uu, Qlf, Uu, Ql, Uu, Qlf, Qlf, Uu, Xu, Xu
Gg^Fet, Gg^Fet, Gs^Gvs, Gs^Gvs, Gs^Fds, Ur^Gvs, Gll^Fp, Gll^Fp, Gg, Wwt, Ww^Bw/r, Wwt^Bw/r, Wwt, Wwt, Gll^Fp, Wwt, Ur, Wwt, Ur^Gvs, Gs^Fms, Hh, Mm, Sm, Sm^Bsb|, Qlf, Uu, Uu, Qlf, Qlf, Ur, Uu, Urc, Urc, Urc, Urc, Sm^Bsb\, Sm^Bsb\, Qlf, Uu, Uu, Uu, Ql, Qlf, Uu, Qlf, Xu
Gg^Fet, Gg^Fet, Gs^Gvs, Kf, Gs^Fds, Gs^Fds, Gs^Fds, Gll^Fp, Gg, Ww^Bw/r, Ur^Gvs, Wwt, Gs^Fms, Gs^Fms, Gs^Fms, Gs^Fds, Gll^Fp, Wwt, Wwt, Ur^Gvs, Wwt, Mm, Sm, Rp, Rp, Uu, Uu, Qlf, Qlf, Ur, Uu, Uu, Uu, Urc, Uu, Ur, Qlf, Ql, Sm^Bsb\, Uu, Uu, Uu, Uu, Qlf, Xu, Xu
Gll^Fp, Gll^Fp, Gs^Fms, Gs^Gvs, Ur^Gvs, Ur^Gvs, Ur^Gvs, Gs^Fms, Gg^Fet, Wwt, Wwt, Gs^Fds, Gs^Fds, Gs^Fds, Gs^Fds, Gs^Fms, Gs^Fms, Gs^Fms, Gs^Fms, Wwt, Wwt, Mm, Sm, Uu^Vu, Uu, Uu, Uu, Uu, Qlf, Uu, Uu, Uu, Uu, Uu, Qlf, Qlf, Sm, Sm, Sm, Sm^Bsb\, Sm^Bsb\, Cfr, Cfr, Uu, Uh, Xu
Gs^Fms, Gs^Fms, Gs^Fms, Rrc^Edb, Gg^Gvs, Gs^Fms, Gs^Fms, Ur^Gvs, Wwt, Wwt, Gg^Fet, Gll^Fp, Gs^Fds, Gs^Fds, Gs^Fms, Gs^Fms, Gll^Fp, Gs^Fds, Gs^Fds, Gs^Fms, Mm, Mm, Ql, Mm, Mm, Uu, Uu, Uu, Qlf, Ur, Uu, Uu, Qlf, Qlf, Sm, Sm, Kh, Sm, Sm, Sm, Rb, Kud, Uu, Uu, Uh, Uu
Gs^Fms, Xof, Gs^Fms, Gs^Fms, Gs^Fms, Xof, Gs^Fms, Gs^Fms, Wwt, Ur^Gvs, Ur^Gvs, Gg^Fet, Gg^Fet, Gg^Fet, Gg^Fet, Gs^Fds, Gs, Gll^Fp, Kvr, Mm, Hh, Mm, Uu, Mm, Uu, Uh, Uu^Vud, Uu, Uu, Qlf, Qlf, Qlf, Qlf, Sm, Sm^Bsb/, Sm^Bsb/, Urc, Sm^Bsb\, Sm^Bsb\, Rb, Urc, Urc, Sm^Bsb/, Uu, Uh, Uu
Gs^Fms, Gs^Fms, Gs^Fms, Ur, Gs^Fms, Gs^Fms, Gs^Fms, Wwt, Ur^Gvs, Ur^Gvs, Gg^Fet, Ur^Gvs, Ur^Gvs, Gg^Fet, Gs, Gs^Fds, Gg^Fet, Rrc, Ur^Gvs, Hh, Hh, Mm, Uu, Uh, Mm, Mm, Mm, Rp, Uu, Sm, Uu, Uu, Sm^Bsb/, Sm^Bsb/, Uu, Uu, Urc, Uu, Rb, Urc, Sm^Bsb/, Ql, Uu, Uu, Uh, Uu
Gs^Fms, Gs^Fms, Gs^Fms, Rrc^Esd, Ur, Gs^Fms, Ur^Gvs, Ur, Ur^Gvs, Gg^Ve, Rp^Gvs, Gg^Fet, Rd^Gvs, Rrc^Gvs, Rrc^Gvs, Gg^Fet, Gg^Fet, Gg^Fet, Hh, Hh, Hh, Md, Ql, Uh, Uh, Uu, Uu, Sm^Bsb|, Uu, Uu, Uu, Uu, Uu, Uu^Vud, Uu, Urc, Uu, Uu, Ql, Sm^Bsb/, Uu, Uu, Uu, Uh, Uh, Uu
Gs^Fds, Gs^Fds, Ur, Rrc, Gs^Fds, Gs^Fds, Rp^Gvs, Gg^Fet, Gs^Fms, Rp, Gs^Fms, Rp, Rp^Gvs, Rrc^Gvs, Gg^Fet, Gg^Fet, Gg^Fet, Gg^Fet, Hh, Gs^Fms, Gs^Fms, Mm, Md, Uh, Uh, Uu, Uu, Ql, Uu, Uu, Uh, Uh, Uh, Rb, Urc, Urc, Sm^Bsb/, Sm^Bsb/, Uu, Uu, Qlf, Ql, Qlf, Uh, Uh, Uu
Gs^Fds, Gs^Fds, Gs^Fms, Gg^Ve, Gs^Fms, Gs^Fms, Gs^Fds, Gg^Fet, Gs^Fds, Gg, Cvr, Cvr, Rp, Rp^Gvs, Gs^Fms, Gg^Fet, Ur, Gg, Hh, Gs^Fms, Hh, Mm, Ql, Uu, Uu, Uu, Uu, Sm^Bsb|, Uu, Uu, Uh, Uh, Cfr, Cfr, Cfr, Sm^Bsb/, Uu, Uu, Qlf, Qlf, Qlf, Qlf, Qlf, Uu, Uh, Uh
Gs^Fds, Gs^Fms, Gll^Fp, Gs^Fms, Gg^Fet, Gs^Fms, Gs^Fms, Gg^Ve, Gs^Fms, Rp, Gs^Fms, 1 Kvr, Cvr, Gs^Fms, Gs^Fms, Gs^Fms, Gs^Fms, Gs, Ur^Gvs, Hh, Md, Mm, Md, Uu, Cfr, Cfr, Ch, Sm^Bsb|, Uu, Ql, Uh, Uh, Cfr, 4 Kud, Cfr, Uu, Uu, Qlf, Qlf, Qlf, Uu, Uu, Uu, Qlf, Uu, Uu
Gs^Fds, Gs^Fms, Gs^Fms, Gll^Fp, Gg^Fet, Kvr, Gs^Fms, Gs^Fms, Gs^Fms, Gs^Fms, Ur^Gvs, Ur^Gvs, Gll^Fp, Cvr, Cvr, Gs^Fms, Gs^Fms, Gll^Fp, Ur^Gvs, Gg^Fet, Hh, Mm, Qlf, Uu, Uu, Kh, Urc, Uu, Uu, Sm^Bsb\, Urc, Sm^Bsb/, Uu, Cfr, Uu, Sm^Bsb\, Sm^Bsb\, Uu, Ql, Uu, Uu, Uh, Uh, Qlf, Qlf, Uu
Gg, Gs^Fms, Gll^Fp, Gs^Fms, Gg^Fet, Gs^Fms, Gg^Fet, Gs^Fms, Gll^Fp, Gs^Fms, Ur, Gg^Gvs, Gll^Fp, Gll^Fp, Gll^Fp, Cvr, Gs^Fms, Gll^Fp, Ur^Gvs, Gg^Fet, Mm, Mm, Qlf, Qlf, Uu, Uu, Uh, Urc, Urc, Urc, Uu, Uu, Uu, Uu, Uu, Ql, Sm, Ql, Uu, Uu, Uh, Uu, Uu, Uh, Qlf, Uu
Gg, Gg^Gvs, Gll^Fp, Gll^Fp, Gg^Fet, Gg^Fet, Gs^Fds, Gs^Fms, Gll^Fp, Gll^Fp, Gll^Fp, Ur, Gs^Gvs, Gll^Fp, Gll^Fp, Cfr, Gs, Gll^Fp, Gll^Fp, Ur^Gvs, Md, Mm, Mm, Uh, Uu, Uu, Uu, Uh, Uh, Qlf, Qlf, Uu, Uu, Uu, Qlf, Qlf, Qlf, Uu, Uu, Uh, Uu, Uu, Qlf, Qlf, Uu, Uu
Gg^Gvs, Gg^Gvs, Gg^Gvs, Gg^Gvs, Gg^Fet, Gg^Fet, Gs^Fds, Gs^Fds, Gg^Fet, Gll^Fp, Gg^Gvs, Gg^Gvs, Ur^Gvs, Gs^Gvs, Gs^Fds, Gs^Fms, Gg^Fet, Gll^Fp, Gg^Ve, Ur^Gvs, Hh, Mm, Qlf, Qlf, Qlf, Qlf, Uu, Uu, Qlf, Uh, Qlf, Qlf, Qlf, Qlf, Qlf, Qlf, Qlf, Ql, Qlf, Uu, Qlf, Qlf, Uu, Uu, Uu, Uu
Gg^Gvs, Gg^Gvs, Gg^Gvs, Gg^Fet, Gg^Gvs, Gg^Fet, Gg^Fet, Gg^Fet, Gg^Gvs, Gg^Gvs, Gs^Fms, Gg^Ve, Gs^Fms, Gs^Fms, Gs^Fms, Gll^Fp, Gg^Fet, Gll^Fp, Ur^Gvs, Ur^Gvs, Md, Mm, Qlf, Qlf, Qlf, Qlf, Qlf, Qlf, Uu, Qlf, Uu, Uu, Uu, Qlf, Uu, Uu, Uu, Qlf, Qlf, Qlf, Qlf, Qlf, Uu, Uu, Uu, Uu
Gg, Gg^Gvs, Gg^Gvs, Gg^Gvs, Gg^Gvs, Gg^Gvs, Gg, Gg^Gvs, Gg^Gvs, Gg^Gvs, Gg, Gs^Fms, Gg, Gs^Fds, Gg, Rp, Gg, Gg, Gg, Ur^Gvs, Gg, Mm, Qlf, Qlf, Qlf, Qlf, Uu, Uu, Gg, Uu, Sm, Uu, Uu, Uu, Uu, Uu, Ww, Uu, Ww, Uu, Ww, Uu, Uu, Uu, Uu, Uu
