Hh, Hh, Hh, Hh, Hh, Ww^Ewf, Ww^Ewf, Ss, Ss, Ss, Ss, Ss, Ss, Re, Hh, Hh, Hh, Hh, Hh, Hh, Hh, Gg, Mm, Ias, Gd, Gd, Gd, Gd, Gd, Gd, Gd, Gd, Gd, Gd, Gd, Gd, Gd, Gd, Ias, Gd, Gd, Gd, Gd, Gd, Gd, Gd
Hh, Hh, Hh^Vhh, Rr, Hh, Ww^Ewf, Ss, Ww^Ewf, Ss, Ww^Ewf, Ss^Vhs, Ss, Rr, Rr, Ww^Ewl, Ww^Ewl, Ww^Ewl, Hh, Hh, Hh, Mm, Mm, Hhd, Gd, Gd, Gd, Ias, Gd, Gll^Fdf, Gd, Gd, Gd, Gll^Fdf, Gd, Gd, Gd, Ias, Ias, Gd^Vhr, Ias, Ias, Ias, Ias, Ias, Gd, Gd
Hh, Hh, Rp, Rr, Hh, Hh, Cme, Ww^Ewf, Ss, Ss, Ss, Rr, Ss^Vhs, Ss, Ss, Ww^Ewl, Ww^Ewl, Kv, Hh, Hh, Hh, Mm, Mm, Gd, Gd, Cf, Cud, Cf, Gll^Fdf, Gd, Gd, Gd, Gd, Gll^Fdf, Gd, Gd, Gd, Ias, Ias, Ias, Ias, Ias, Ias, Ias, Gd, Gd
Re, Ss, Ww^Bsb|, Hh, Ww^Ewf, Cme, Re, Cme, Cme, Ww^Ewf, Ww^Ewf, Rr, Rr, Ss, Ww^Ewl, Ww^Ewl, Ss, Qxu^Bcx|, Gll^Ftr, Gll^Ftr, Hh, Mm, Mm, Gd, Ias, Cf, Ias, Cf, Gll^Fdf, Gll^Fdf, Gd^Vhr, Gd, Gd, Gll^Fdf, Gll^Fdf, Gd, Gd, Ias, Ias, Ias, Ias, Ias, Gd^Vhr, Ias, Ias, Gd
Re, Ww^Ewf, Ww^Bsb|, Ww^Ewf, Gll^Ftr, Gll^Ftr, Re, Kh, Qxu^Bs\, Ww^Ewf, Ww^Ewf, Ww^Ewf, Rr, Gll^Ftr, Gll^Ftr, Ww^Ewl, Rr, Rr, Rr, Gll^Ftr, Hh, Md, Mm, Gd, Ias, Ias, Ias, Ias, Gll^Fmf, Gll^Fmf, Ias, Ias, Cf, Gd, Gll^Fdf, Gd, Gd, Gd, Gd, Ias, Ias, Ias, Ias, Ias, Ias, Gd
Rr, Rr, Rr, Ww^Ewf, Gll^Ftr, Gll^Ftr, Gll^Ftr, Re, Gll^Ftr, Ww^Ewf, Ww^Ewl, Gll^Ftr, Rr, Hhd^Dr, Rr, Rr, Rr, Rr, Ww^Ewl, Ww^Ewl, Hh, Mm, Hhd, Mm, Gd, Ias, Ias, Ias, Gd, Gll^Fdf, Gd, Cf, Cud, Cf, Gd, Gll^Fdf, Gll^Fmf, Gd, Gll^Fmf, Gd, Gd, Gll^Fdf, Gll^Fmf, Gd, Ias, Gd
Re, Gs^Vht, Rr, Ww^Ewf, Re, Gll^Ftr, Gll^Ftr, Gll^Ftr, Ww^Ewl, Ww^Ewl, Gll^Ftr, Gll^Ftr, Gll^Ftr, Rr, Rr, Rr, Ww^PsgS, Ww^Ewl, Gll^Ftr, Gll^Ftr, Mm, Hhd, Hhd, Gd, Ias, Ias, Gd, Gd, Gd, Gd, Gd, Cf, Cf, Cf, Gd, Gll^Fdf, Gll^Fmf, Gll^Fmf, Gll^Fmf, Gll^Fmf, Gll^Fmf, Gll^Fmf, Gll^Fdf, Gll^Fdf, Ias, Ias
Re, Rr, Qxu^Bh/, Chs, Ss, Gll^Ftr, Ww^Ewl, Ww^Ewl, Ww^Ewl, Gll^Ftr, Gll^Ftr, Gll^Ftr, Gll^Ftr, Gll^Ftr, Ww^Ewl, Ww^Ewl, Gll^Ftr, Gg^Gvs, Gll^Ftr, Gg^Gvs, Hhd, Hhd, Hhd, Gd, Ias, Gd, Gd, Gd, Gll^Fdf, Gll^Fdf, Gll^Fdf, Gd, Ias, Ias, Gd, Gd, Gll^Fdf, Gll^Fdf, Gd^Vhr, Gll^Fmf, Gll^Fdf, Gll^Fdf, Gll^Fdf, Ias, Ias, Gd
Ss, Ss, Ss, Ss, Ss, Ww^Ewl, Ww^Ewl, Ww^Ewl, Re^Gvs, Re^Gvs, Ww^Ewl, Kme, Cme, Kme, Ww^Vm, Ww^Ewl, Gll^Ftr, Gll^Ftr, Ss, Gg^Gvs, Mm, Mm, Gd, Ias, Gd^Vhr, Gll^Fmf, Gd, Gd, Gll^Fdf, Gll^Fmw, Gll^Fdf, Gd, Ias, Ias, Ias, Gd, Gd, Gll^Fdf, Gll^Fdf, Gll^Fdf, Gll^Fdf, Gd^Vhr, Gll^Fdf, Gll^Fdf, Gd, Gd
Ss, Ss, Ss, Ss^Vhs, Rr^Bw\r, Ww^Ewl, Ww^Ewl, Re^Gvs, Rr, Re^Gvs, Ww^Ewl, Re^Gvs, Mm, 2 Kh, Cme, Gll^Ftr, Ss, Ss, Ss, Hh, Hh, Mm, Gd, Ias, Ias, Gd, Gd, Gll^Fmf, Gll^Fdf, Gll^Fmw, Gll^Fmw, Gd, Gd, Ias, Ias, Gd, Gd, Gd, Gll^Fdf, Gll^Fdf, Gll^Fmf, Gll^Fdf, Gll^Fmf, Gll^Fdf, Gd, Gd
Ss, Ss, Ww^Ewf, Ss, Ww^Ewf, Ww^Bw\r, Ww^Bw\r, Rr, Gs^Vht, Rr, Ww^Ewl, Re^Gvs, Ww^Ewl, Ww^Ewl, Kme, Gll^Ftr, Ss, Gll^Ftr, Ss, Ss, Hh, Mm, Gd, Gd, Cf, Cud, Cf, Gll^Fdf, Gll^Fmw, Gll^Fmf, Gll^Fdf, Gd, Gll^Fmw, Gd, Ias, Ias, Gd, Gd, Gll^Fmf, Gll^Fmf, Gll^Fmf, Gll^Fmf, Gll^Fdf, Gll^Fdf, Gd, Gd
Ss, Ss, Rr, Ww^Ewf, Ww^Ewf, Ww^Ewl, Ww^Ewf, Rr, Rr, Rr, Ww^Ewl, Ww^Ewl, Ww^Ewl, Kme, Ww^Ewl, Kme, Ss, Ss, Ww^Ewl, Ww^Ewl, Mm, Hh, Mm, Gd, Ias, Gd, Gd, Gd, Gll^Fmf, Gll^Fmf, Gll^Fmf, Gll^Fmf, Gll^Fmf, Gd, Gd, Ias, Gd, Gd, Gd, Gll^Fmf, Gll^Fdf, Gll^Fmf, Gll^Fmf, Gll^Fmf, Gd, Gd
Ww^Ewf, Ww^Ewf, Ww^Ewf, Ww^Ewf, Ss, Ww^Ewf, Ww^Ewl, Ww^Ewl, Ww^Ewl, Ww^Bsb\, Rr, Ww^Ewl, Ww^Ewl, Ww^Ewl, Ww^Ewl, Ww^Ewl, Ww^Ewl, Ww^Ewl, Ww^Vm, Ww^Ewl, Mm, Kme, Md, Md, Ias, Gd^Vhr, Gll^Fdf, Gll^Fdf, Gll^Fmf, Gll^Fmf, Gll^Fdf, Gll^Fdf, Gll^Fmw, Gll^Fmf, Gll^Fmf, Ias, Ias, Gd, Gll^Fdf, Gll^Fdf, Gll^Fdf, Gd, Gd, Rp, Wwf, Gd
Ww^Ewf, Rr, Re^Gvs, Kh, Ww^Ewf, Ww^Ewf, Ww^Ewf, Ww^Ewf, Ww^Ewf, Ww^Ewf, Rr, Rr, Rr, Ww^Ewl, Ww^Ewl, Ww^Ewl, Ww^Ewl, Ww^Vm, Ww^Ewl, Ww^Ewl, Ww^Ewl, Mm, Ur, Gd, Rb, Ias, Gll^Fdf, Gll^Fdf, Gll^Fdf, Gll^Fmf, Gll^Fmw, Gd, Gll^Fdf, Gll^Fdf, Gd, Gll^Fdf, Gd, Ias, Gd, Gd, Sm, Gd, Sm, Gd, Wwf, Xu
Ww^Ewf, Ww^Ewf, Re^Gvs, Qxu^Bs|, Ww^Ewf, Ss, Ss, Ss, Ww^Ewf, Ww^Ewf, Rr, Cm, Ww^Ewl, Ww^Ewl, Ww^Ewl, Ss, Ww^Ewl, Ww^Ewl, Ww^Ewl, Ww^Ewl, Ww^Ewl, Ur, Wwt, Wwt, Rb, Wwt, Wwf, Wwf, Wwf, Gll^Fdf, Gll^Fdf, Gll^Fmw, Sm, Sm, Sm, Gd, Wwf, Sm, Sm, Sm, Sm, Sm, Wwf, Wwf, Wwf, Xu
Ww^Ewf, Ss, Ss, Re^Gvs, Ww^Ewf, Ss, Ss, Ss, Ss, Ww^Ewf, Ww^Ewf, Rr, Rr, Ww^Ewl, Ww^Ewl, Ww^Ewl, Ww^Ewl, Ww^Ewl, Ww^Ewl, Ww^Ewl, Hh, Ur, Wwt, Rr^Vhc, Rb, Rb, Rb, Wwt, Wwt, Wwf, Wwf, Wwf, Wwf, Wwf, Wwf, Wwf, Wwf, Wwf, Wwf, Wwf, Wwf, Sm, Wwf, Sm, Xu, Xu
Gg, Ww^Ewf, Gg, Re^Gvs, Gg, Ss, Gg, Ss, Gg, Ww^Ewf, Gg, Ww^Ewf, Gg, Ww^Ewl, Gg, Ww^Ewl, Ww^Ewl, Ww^Ewl, Gg, Gg, Hh, Mm, Wwt, Rp, Wwt, Wwt, Wwt, Wwt, Wwt, Wwt, Wwt, Wwf, Wwt, Wwt, Rb, Wwt, Rr^Vhc, Wwt, Wwt, Wwf, Sm, Wwf, Wwt, Wwf, Sm, Xu
Gs, Gg, Gg, Gg, Gg, Gg, Gg, Gg, Gg, Gg, Gg, Gg, Ur, Gg, Ur, Gg, Gg, Gg, Gg, Gg, Hh, Md, Wwt, Wwt^Bsb|, Wwt, Wwt, Wwt, Wwt, Wwt, Wwt, Wwt, Wwt, Wwt, Wwt, Wwt, Rb, Rb, Rb, Wwt, Wwt, Wwt, Wwt, Wwt, Wwt, Xu, Xu
Gs, Gs, Gs, Ur, Gg, Gg, Ur, Ur, Ur, Wwt, Gg, Ur, Gg^Bw/r, Gg, Wwt, Wwt, Wwt, Gg, Ur, Gg, Hh, Md, Wwt, Wwt^Bsb|, Wwt, Wwt, Wwt, Ww, Ww, Wwt, Wwt, Wwt, Wwt, Wwt, Rb, Rb, Wwt, Wwt, Wwt, Wwt, Wwt, Wwt, Wwrg, Wwrg, Xu, Xu
Gs, Gs, Irs, Gs, Irs, Ur, Gll, Ur, Gg, Wwt, Ww^Bw/r, Wwt^Bw/r, Wwt, Wwt, Gll, Wwt, Ur, Wwt, Ur, Gll, Hh, Mm, Wwt, Ww^Bsb|, Ww, Wwt, Wwt, Ww, Ww, Wwt, Ww, Wwt, Wwt, Wwt, Wwt, Wwt^Bsb\, Wwt^Bsb\, Wwt, Wwt, Wwt, Wwt, Wwt, Wot, Wwrg, Wwrt, Xu
Irs, Irs, Irs, Kf, Irs, Irs, Irs, Gg, Gg, Ww^Bw/, Ur, Wwt, Gs^Fms, Gs^Fms, Gs^Fms, Gs^Fds, Gg, Wwt, Wwt, Ur, Wwt, Mm, Wwt, Rp, Rp, Wwg, Wwt, Wwt, Wwt, Ww, Wwt, Ww, Wwt, Wwt, Wwt, Wwt, Wwt, Wwt^Bsb\, Wwt^Bsb\, Wwt, Wwt, Wwt, Wwt, Wwrg, Xu, Xu
Gg, Irs, Rra, Rra, Ur, Ur, Ur, Irs, Irs, Wwt, Wwt, Gg, Gg, Gg, Gg, Gs^Fms, Gs^Fms, Ur, Ur, Wwt, Wwt, Mm, Wwt, Rr^Vhc, Wwt, Wwt, Wwt, Wwt, Wwt, Ww, Ww, Ww, Ww, Wwt, Ww, Ww, Wwt, Wwt, Wwt, Wwt^Bsb\, Wwt^Bsb\, Cme, Cme, Wwt, Wwr, Xu
Gg, Gs^Gvs, Gs^Gvs, Rra^Esd, Gg^Gvs, Gs^Gvs, Gs^Gvs, Ur, Wwt, Wwt, Irs, Gg, Gg, Gg, Gg^Edp, Gg, Gg, Ur, Ur, Ur, Mm, Mm, Wwt, Mm, Mm, Wwt, Rb, Wwt, Ww, Wwt, Wwt, Ww, Ww, Ww, Wwg, Wwg, Kh, Wwt, Wwt, Wwt, Rb, Km, Rb, Wwf, Ww, Wwrt
Gg, Xof, Gs^Gvs, Rra, Gs^Gvs, Xof, Gs^Gvs, Gs^Gvs, Wwt, Ur, Ur, Irs, Irs, Gll, Gs, Gg, Irs, Irs, Cv, Mm, Hhd, Mm, Wwt, Mm, Wwt, Uue, Rr^Vhc, Wwg, Ww, Wwt, Wwg, Wwt, Wwg, Wwg, Sm^Bsb/, Sm^Bsb/, Rb^Gvs, Sm^Bsb\, Sm^Bsb\, Rb, Wwt, Wwt, Sm^Bsb/, Rb, Wwrt, Wwrt
Gs^Gvs, Gs^Gvs, Gs^Gvs, Rra, Gs^Gvs, Gs^Gvs, Gs^Gvs, Wwt, Ur, Ur, Gg^Fet, Ur, Ur, Irs, Irs, Irs, Rrc, Rrc, Ur, Hhd, Hhd, Mm, Wwt, Uhe, Mm, Mm, Mm, Rp, Ww, Wwg, Wwg, Wwg, Sm^Bsb/, Sm^Bsb/, Rb^Gvs, Rb^Gvs, Gs, Rb^Gvs, Rb^Gvs, Rb, Sm^Bsb/, Sm^Bsb/, Wwt, Wwt, Wwrg, Wwrt
Gs^Gvs, Gs^Gvs, Gs^Gvs, Rrc^Esd, Ur, Gs^Gvs, Ur, Ur, Ur, Gg^Ve, Rp^Gvs, Gg^Fet, Rd, Rrc^Edb, Rrc, Rrc, Gs, Gs, Hhd, Hhd, Hhd, Md, Wwt, Wwt, Wwt, Wwt, Wwt, Wwt^Bsb|, Ww, Wwg, Wot, Rb, Rb^Gvs, Rr^Vhc, Rb^Gvs, Rb^Gvs, Gs, Gs, Sm^Bsb/, Sm^Bsb/, Ww, Wwt, Ww, Ww, Wwrt, Wwrt
Ur, Ur, Ur, Rrc, Rp, Rp^Gvs, Rp, Gg^Fet, Irs, Rp, Irs, Rp, Rp, Rrc^Edb, Gg^Ve, Gs, Gs, Gs, Hhd, Gs^Fms, Gs^Fms, Mm, Md, Wwt, Wwt, Ww, Ww, Ww^Bsb|, Wog, Wot, Rb, Gs, Rb^Gvs, Rb^Gvs, Rb^Gvs, Gs, Sm^Bsb/, Sm^Bsb/, Ww, Ww, Ww, Ww, Ww, Ww, Wwrt, Wwrt
Ur, Ur, Gs^Fms, Gg^Ve, Gs^Fms, Rp, Irs, Irs, Gs^Fds, Gg, Cv, Cv, Rp, Rp, Irs, Ur, Ur, Gg^Ve, Hh, Gs^Fms, Hh, Mm, Wwt, Wwt, Wwt, Wwt, Wwt, Wog^Bsb|, Rb, Rb, Rb^Gvs, Rb^Gvs, Ch, Ch, Cme, Sm^Bsb/, Ww, Ww, Ww, Ww, Wot, Ww, Ww, Ww, Wwrt, Wwrt
Gs, Gs^Fms, Gll^Fp, Gs^Fms, Gs, Gs, Irs, Gg^Ve, Irs, Rp, Irs, 1 Kvr, Cv, Irs, Irs, Irs, Gg^Fet, Gs, Ur, Hh, Md, Mm, Md, Wwt, Cme, Cme, Ch, Wog^Bsb|, Rb, Wog, Rb, Rb^Gvs, Cme, Km, Cme, Ww, Ww, Ww, Ww^Ii, Ww, Wot, Ww, Ww, Ww, Wwrt, Wwrt
Gll^Fp, Gs^Fms, Gs^Fms, Gll^Fp, Gs, Kv, Ur, Ur, Gs^Fms, Irs, Ur, Ur, Irs, Cv, Cv, Gs, Gs, Gs, Ur, Ur, Hh, Mm, Wwt, Gs, Gs, Kh, Rb, Rb, Wog, Wog^Bsb\, Rb, Sm^Bsb/, Ww, Cme, Ww, Ww^Bsb\, Ww^Bsb\, Ww^Ii, Ww, Ww, Ww, Ww, Ww, Ww, Wot, Wwrt
Gg, Gs^Fms, Gg^Gvs, Gg, Ur, Gs^Fms, Ur, Ur, Gll^Fp, Gs^Fms, Ur, Irs, Irs, Irs, Irs, Cv, Gs, Gs, Ur, Ur, Mm, Mm, Wwt, Wwt, Gs, Gs, Ww, Wog, Wog^Ii, Wog, Wog, Ww, Wot, Wot^Ii, Wot, Ww^Ii, Ww, Ww^Bsb\, Rb, Rb, Uhe, Ww, Ww, Wot, Wwrt, Wwrt
Gg, Gg^Gvs, Gg^Gvs, Gg^Gvs, Gg^Fet, Gg^Fet, Gs^Fds, Gs^Fms, Gll^Fp, Gll^Fp, Gll^Fp, Ur, Gs^Gvs, Irs, Irs, Kf, Gs, Gs, Gs, Ur, Md, Mm, Mm, Rr^Vhc, Wwt, Ww, Ww, Ww, Ww, Wog^Ii, Wog, Ww^Ii, Wot, Wot^Ii, Ww, Ww^Ii, Ww, Ww, Rb^Gvs, Rr^Vhc, Ww, Ww, Ww, Wot, Wwrg, Wwrt
Gg^Gvs, Gg^Gvs, Gg^Gvs, Gg^Gvs, Gg^Fet, Gg^Fet, Gs^Fds, Gs^Fds, Gg^Fet, Gll^Fp, Gg^Gvs, Gg^Gvs, Ur, Gs^Gvs, Gs, Gs, Gg^Fet, Gs, Gg^Ve, Ur, Hh, Mm, Wwt, Wwt, Ww, Ww, Wwt, Ww, Ww, Wog, Ww, Ww, Ww, Ww, Ww^Ii, Ww, Ww, Ww, Ww, Rb^Gvs, Ww, Wot, Ww, Wwrg, Wwrt, Wwrt
Gg^Gvs, Gg^Gvs, Gg^Gvs, Gg^Fet, Gg^Gvs, Gg^Fet, Gg^Fet, Gg^Fet, Gg^Gvs, Gg^Gvs, Gg^Gvs, Gg^Ve, Rp, Gs^Fms, Gs^Fms, Gs, Gg^Fet, Gs, Ur, Ur, Md, Mm, Wwt, Wwt, Ww, Ww, Ww, Ww, Ww, Ww, Ww, Ww, Ww, Ww, Ww, Ww, Wwr, Ww, Ww, Wwr, Ww, Wot, Ww, Wwrt, Wwrt, Wwrt
Gg, Gg^Gvs, Gg^Gvs, Gg^Gvs, Gg^Gvs, Gg^Gvs, Gg, Gg^Gvs, Gg^Gvs, Gg^Gvs, Gg, Gg, Gg, Ur, Gg, Rp, Gg, Gg, Gg, Ur, Gg, Mm, Gg, Wwr, Gg, Ww, Gg, Ww, Gg, Ww, Sm, Ww, Ww, Ww, Ww, Ww, Ww, Ww, Ww, Ww, Ww, Ww, Gg, Wwrt, Sm, Wwrt
